RegionType,RegionName,StateName,MSAName,AllHomes_Tier1,AllHomes_Tier2,AllHomes_Tier3,AllHomes_AllTiers,UWHomes_Tier1,UWHomes_Tier2,UWHomes_Tier3,UWHomes_AllTiers,UWHomes_TotalValue_Tier1,UWHomes_TotalValue_Tier2,UWHomes_TotalValue_Tier3,UWHomes_TotalValue_AllTiers,UWHomes_MedianValue_AllTiers,AllHomes_Tier1_ShareUW,AllHomes_Tier2_ShareUW,AllHomes_Tier3_ShareUW,AllHomes_AllTiers_ShareUW,UWHomes_ShareInTier1,UWHomes_ShareInTier2,UWHomes_ShareInTier3
Nation,United States,NA,NA,35461549,35452941,35484532,106399022,594672,542681,725955,1863308,122991900758,195513109667,597449352579,915954363004,310306,0.01676948742425211,0.015307079883725302,0.02045835069770682,0.017512454202821527,0.3191485250962267,0.2912459990511499,0.3896054758526234
State,Alabama,Alabama,NA,546670,520247,491300,1558217,2890,2766,5046,10702,365986699,629176919,2583039495,3578203113,270254,0.005286553130773593,0.005316705334197026,0.010270710360268675,0.006868106303550789,0.27004298262007104,0.25845636329658006,0.4715006540833489
State,California,California,NA,3060171,3076238,3169584,9305993,8090,14266,17783,40139,4859725390,12969249624,26666381753,44495356767,860373,0.002643643116675506,0.004637482535486526,0.005610515449346034,0.004313242015118644,0.2015496150875707,0.3554149331074516,0.4430354518049777
State,Connecticut,Connecticut,NA,333904,334688,336254,1004846,4434,3807,7289,15530,1024758399,1807460170,8689479570,11521698139,442036,0.013279265896784704,0.011374772922841572,0.02167706555163656,0.015455104563286314,0.2855119124275596,0.2451384417256922,0.4693496458467482
State,Delaware,Delaware,NA,102983,127573,127983,358539,4105,2574,3286,9965,615890421,687943979,1498012532,2801846932,241344.5,0.039860947923443676,0.02017668315395891,0.025675284998788902,0.02779335023526032,0.4119417962870045,0.25830406422478674,0.32975413948820875
State,Florida,Florida,NA,2391491,2435575,2456637,7283703,313090,263276,331817,908183,53776974685,84327562563,278243647354,416348184602,276690,0.13091832668406447,0.10809603481724028,0.1350696093887701,0.1246869895711014,0.34474329512884516,0.2898931162552041,0.36536358861595075
State,Georgia,Georgia,NA,1003890,986416,920843,2911149,5433,6904,9831,22168,1143841779,2318976705,6102691239,9565509723,295405,0.00541194752413113,0.006999075440787659,0.010676087020262955,0.007614862722588229,0.24508300252616383,0.31143991338866833,0.4434770840851678
State,Hawaii,Hawaii,NA,132718,132760,139397,404875,16716,12536,7201,36453,5861105917,7957929785,11347781227,25166816929,500666,0.1259512650883829,0.09442603193733053,0.05165821359139723,0.09003519604816301,0.4585630812278825,0.3438948783364881,0.19754204043562945
State,Louisiana,Louisiana,NA,439606,424665,417773,1282044,25678,23280,25237,74195,2767882743,3568865248,6755053878,13091801869,149888,0.05841139565883996,0.054819681395923844,0.06040840360674338,0.0578724287153951,0.3460880113215176,0.31376777410876744,0.34014421456971494
State,Massachusetts,Massachusetts,NA,610378,611776,611920,1834074,16830,16491,24935,58256,5994030087,9525942056,34367948613,49887920756,582126,0.027573077666626256,0.02695594465948321,0.04074879069159367,0.03176316768025718,0.28889728096676737,0.2830781378742104,0.42802458115902225
State,Maryland,Maryland,NA,654264,683706,701183,2039153,17770,18312,25466,61548,2705831641,4245809177,12101180742,19052821560,246266,0.027160290035826515,0.026783442005774413,0.03631862152961495,0.030183120148414563,0.2887177487489439,0.2975238837980113,0.4137583674530448
State,Maine,Maine,NA,134505,134284,137197,405986,593,962,3024,4579,107627974,299466370,2132161471,2539255815,457768,0.004408758038734619,0.007163921241547765,0.02204129827911689,0.011278714044326652,0.12950425857174055,0.21008953920069884,0.6604062022275606
State,Mississippi,Mississippi,NA,256076,245298,239117,740491,1382,1618,2324,5324,97948864,185605914,602039997,885594775,129395,0.005396835314516003,0.006596058671493449,0.009719091490776481,0.007189824049178181,0.2595792637114951,0.30390683696468823,0.4365138993238167
State,North Carolina,North Carolina,NA,1100343,1089319,1045562,3235224,15113,15608,22517,53238,2597176266,4473007155,12479813258,19549996679,273856,0.013734808146187143,0.014328217904947954,0.021535786495683662,0.01645573845891351,0.2838761786693715,0.2931740486118938,0.42294977271873474
State,New Hampshire,New Hampshire,NA,166262,166350,166572,499184,1444,780,1333,3557,259073626,331450182,1067336924,1657860732,355053,0.008685087392188233,0.004688908926961226,0.008002545445813221,0.0071256290265713645,0.4059600787180208,0.21928591509699186,0.37475400618498733
State,New Jersey,New Jersey,NA,843411,853312,852376,2549099,58500,55897,65713,180110,16980012356,26057725257,51944171752,94981909365,387284.5,0.06936120112258436,0.06550593452336309,0.0770939116070842,0.07065633778837149,0.3248015101882183,0.31034923102548445,0.36484925878629726
State,New York,New York,NA,1379090,1378613,1379063,4136766,27930,23837,36380,88147,12122607262,15090539538,42724503890,69937650690,550632,0.02025248533453219,0.017290566678248357,0.026380230634858597,0.021308190987839294,0.3168570683063519,0.27042327021906587,0.4127196614745822
State,Oregon,Oregon,NA,387584,396357,425236,1209177,2127,1045,772,3944,370428423,255049746,299705574,925183743,212916,0.005487842635402906,0.0026365120333436774,0.0018154624726034485,0.003261722642756189,0.5393002028397565,0.26495943204868155,0.19574036511156187
State,Pennsylvania,Pennsylvania,NA,1362298,1372808,1361090,4096196,338,811,1489,2638,40191013,125154853,589628797,754974663,196745.5,2.4811017853656103e-4,5.907599606062902e-4,0.001093976151466839,6.440121517622692e-4,0.1281273692191054,0.30742987111448067,0.564442759666414
State,Rhode Island,Rhode Island,NA,104275,104686,104762,313723,956,908,2529,4393,248316569,383451073,2130859220,2762626862,473666,0.009168065212179333,0.008673557113654166,0.02414043259960673,0.014002798647214262,0.21761893922148873,0.20669246528568178,0.5756885954928295
State,South Carolina,South Carolina,NA,598931,571984,538676,1709591,18135,19639,34736,72510,4385718186,8362718074,31309892968,44058329228,426691,0.030278946990554837,0.03433487650004196,0.06448403121728088,0.04241365332409915,0.2501034340091022,0.2708454006343953,0.47905116535650255
State,Texas,Texas,NA,2441330,2510534,2337787,7289651,12771,13126,16979,42876,1580907542,2595481975,7167311675,11343701192,205095.5,0.005231164979744647,0.0052283697412582346,0.0072628515771539495,0.005881763063828433,0.2978589420654912,0.3061386323351059,0.3960024255994029
State,Virginia,Virginia,NA,811870,827585,823238,2462693,11027,12580,21009,44616,1755121920,2967491036,9337627307,14060240263,257806.5,0.013582223755034673,0.015200855501247605,0.02551995899120303,0.018116752676846037,0.24715348753810293,0.28196162811547426,0.4708848843464228
State,Washington,Washington,NA,731158,756879,780705,2268742,8945,5833,12524,27302,1363536116,1496416676,10500835756,13360788548,325471,0.012234017818310133,0.007706647958260171,0.016041910836999893,0.01203398182781471,0.32763167533514026,0.21364735184235586,0.45872097282250385
County,Bay,Florida,NA,29094,29584,26728,85406,1145,1864,2795,5804,122900223,364963507,1115379178,1603242908,228448,0.03935519351068949,0.06300703082747432,0.10457198443579767,0.06795775472449242,0.1972777394900069,0.321157822191592,0.4815644383184011
County,Lee,Florida,NA,106331,106576,106924,319831,17339,14787,21199,53325,3510683061,5538566638,16304273276,25353522975,327242,0.1630662741815651,0.13874605915027774,0.19826231715985185,0.16672867858337684,0.3251570557899672,0.27729957805907174,0.3975433661509611
County,Clay,Florida,NA,23082,24291,22041,69414,252,581,1150,1983,35420092,123459428,608571765,767451285,293353,0.010917598128411749,0.023918323658968343,0.05217549113016651,0.02856772409024116,0.12708018154311648,0.2929904185577408,0.5799293998991427
County,Coos,Oregon,NA,6590,6598,6609,19797,180,127,167,474,23494389,23937672,49465458,96897519,181966.5,0.027314112291350532,0.01924825704759018,0.0252685731578151,0.023943021669949993,0.379746835443038,0.2679324894514768,0.35232067510548526
County,Dare,North Carolina,NA,3109,3100,3354,9563,1389,1483,1785,4657,292308337,427267669,888618370,1608194376,289966,0.446767449340624,0.47838709677419355,0.5322003577817531,0.4869810728850779,0.298260682843032,0.3184453510843891,0.38329396607257893
County,Gulf,Florida,NA,2824,2820,2884,8528,246,286,528,1060,31182010,65160478,291212569,387555057,300352.5,0.08711048158640226,0.10141843971631205,0.18307905686546463,0.12429643527204502,0.2320754716981132,0.269811320754717,0.4981132075471698
County,Hyde,North Carolina,NA,224,246,267,737,203,232,235,670,17150124,25510536,46206771,88867431,111958,0.90625,0.943089430894309,0.8801498127340824,0.9090909090909091,0.3029850746268657,0.34626865671641793,0.35074626865671643
County,Kent,Delaware,NA,27102,33612,25169,85883,801,451,353,1605,87967191,73929649,126144656,288041496,131933,0.029555014390081912,0.013417826966559562,0.014025189717509635,0.018688215362760965,0.49906542056074765,0.2809968847352025,0.21993769470404984
County,Kent,Maryland,NA,4089,3517,3771,11377,188,327,457,972,28339349,66228079,240580534,335147962,226567,0.04597701149425287,0.09297696900767699,0.12118801378944577,0.08543552781928453,0.1934156378600823,0.33641975308641975,0.47016460905349794
County,Kent,Rhode Island,NA,19472,19498,18461,57431,111,61,344,516,21594170,16195502,129819221,167608893,278937.5,0.005700493015612161,0.00312852600266694,0.01863387682140729,0.00898469467709077,0.21511627906976744,0.1182170542635659,0.6666666666666666
County,King,Washington,NA,199867,199392,204970,604229,697,273,1603,2573,264059486,166935569,2812083508,3243078563,877144,0.0034873190671796746,0.0013691622532498796,0.00782065668146558,0.004258319279610876,0.2708900116595414,0.10610182666148466,0.623008161678974
County,Knox,Maine,NA,4703,4742,4798,14243,28,29,54,111,4992239,7508739,28773662,41274640,332251,0.005953646608547736,0.006115563053563897,0.011254689453939141,0.007793301972898968,0.25225225225225223,0.26126126126126126,0.4864864864864865
County,Levy,Florida,NA,6343,5745,4468,16556,296,388,407,1091,27268786,67579523,133766352,228614661,184197,0.0466656156392874,0.06753698868581375,0.09109221128021486,0.06589755979705243,0.27131072410632445,0.3556370302474794,0.37305224564619616
County,Maui,Hawaii,NA,17581,17538,19929,55048,396,439,324,1159,105264368,214124568,277843038,597231974,389965,0.022524316022979354,0.02503136047439845,0.016257714887851875,0.021054352565034153,0.34167385677308026,0.3787748058671268,0.27955133735979293
County,Pitt,North Carolina,NA,22042,19844,18836,60722,71,34,23,128,6492558,4484984,6786239,17763781,99179.5,0.0032211233100444604,0.0017133642410804273,0.0012210660437460183,0.0021079674582523632,0.5546875,0.265625,0.1796875
County,York,Maine,NA,27184,27510,29785,84479,330,528,2292,3150,61809256,167737905,1758874862,1988422023,502459.5,0.012139493819894055,0.019193020719738278,0.07695148564713782,0.03728737319333799,0.10476190476190476,0.1676190476190476,0.7276190476190476
County,York,Virginia,NA,6907,6712,5867,19486,316,292,271,879,66283344,88769115,130847e3,285899459,294582,0.0457506877081222,0.043504171632896306,0.04619055735469576,0.04510930924766499,0.3594994311717861,0.3321956769055745,0.3083048919226394
County,Bronx,New York,NA,61944,17676,1903,81523,705,127,43,875,290819040,89575309,49384535,429778884,426935,0.011381247578457963,0.0071848834577958815,0.02259590120861797,0.01073316732701201,0.8057142857142857,0.14514285714285713,0.04914285714285714
County,Bryan,Georgia,NA,3632,4118,4017,11767,79,248,480,807,12493167,57581454,186895031,256969652,288226,0.021751101321585902,0.06022340942204954,0.11949215832710978,0.06858162658281636,0.09789343246592318,0.3073110285006196,0.5947955390334573
County,Bucks,Pennsylvania,NA,68882,70316,72288,211486,123,100,129,352,19712584,21126192,37467727,78306503,210529,0.0017856624372114631,0.0014221514306843393,0.0017845285524568392,0.0016644127743680433,0.3494318181818182,0.2840909090909091,0.3664772727272727
County,Cecil,Maryland,NA,14284,14292,14291,42867,140,193,376,709,23185348,40891856,183148357,247225561,258596,0.009801176141136937,0.01350405821438567,0.026310265201875307,0.016539529241607762,0.19746121297602257,0.27221438645980256,0.5303244005641748
County,Dixie,Florida,NA,2768,1982,1988,6738,340,466,507,1313,27685834,60413466,129360932,217460232,143274,0.12283236994219653,0.23511604439959638,0.2550301810865191,0.19486494508756308,0.25894897182025894,0.3549124143183549,0.38613861386138615
County,Dukes,Massachusetts,NA,4635,4737,5190,14562,95,100,367,562,47319464,92244708,901500129,1041064301,1549919.5,0.020496224379719527,0.021110407430863416,0.07071290944123314,0.03859359978024997,0.16903914590747332,0.17793594306049823,0.6530249110320284
County,Duval,Florida,NA,97020,97097,97063,291180,3458,3054,8042,14554,419282695,661894663,3691137259,4772314617,254294.5,0.03564213564213564,0.03145308299947475,0.0828534044898674,0.04998282849096779,0.23759791122715404,0.2098392194585681,0.5525628693142779
County,Essex,Massachusetts,NA,70001,70107,69819,209927,1795,1351,1723,4869,517650305,581057977,1397660177,2496368459,403032,0.025642490821559692,0.019270543597643602,0.024678096220226587,0.02319377688434551,0.3686588621893613,0.27746970630519613,0.3538714315054426
County,Essex,New Jersey,NA,50969,51304,51125,153398,71,79,315,465,13968137,19405667,113259884,146633688,308990,0.0013930035904177048,0.0015398409480742242,0.006161369193154034,0.003031330265062126,0.15268817204301074,0.16989247311827957,0.6774193548387096
County,Essex,Virginia,NA,1665,1635,1631,4931,2,91,249,342,261398,16987396,89004876,106253670,276719,0.0012012012012012011,0.05565749235474006,0.15266707541385652,0.06935712837152708,0.005847953216374269,0.26608187134502925,0.7280701754385965
County,Glynn,Georgia,NA,12923,13200,13797,39920,2511,2868,4554,9933,578290348,1263104341,3350982221,5192376910,292525,0.19430472800433335,0.21727272727272728,0.33007175472928896,0.24882264529058115,0.252793717909997,0.2887345212926608,0.4584717607973422
County,Horry,South Carolina,NA,51229,57223,43023,151475,1637,2004,3513,7154,200769227,416366656,1518745231,2135881114,250588,0.03195455698920533,0.03502088321129616,0.08165399902377798,0.047228915662650604,0.22882303606374058,0.2801230081073525,0.49105395582890693
County,Kauai,Hawaii,NA,8442,8406,9751,26599,511,231,376,1118,201284143,177754402,547785060,926823605,508299.5,0.06053067993366501,0.027480371163454677,0.038560147677161316,0.042031655325388176,0.45706618962432916,0.20661896243291591,0.3363148479427549
County,Kings,New York,NA,39950,85625,128621,254196,5030,2953,2049,10032,2405227190,2119700312,3383239793,7908167295,581450,0.12590738423028786,0.034487591240875914,0.01593052456441794,0.039465609214936505,0.5013955342902712,0.29435805422647526,0.2042464114832536
County,Mason,Washington,NA,9794,9631,9806,29231,82,244,1365,1691,12602011,59296953,685872056,757771020,415872,0.008372472942617929,0.02533485619354169,0.1392004894962268,0.057849543293079266,0.04849201655824956,0.14429331756357186,0.8072146658781786
County,Ocean,New Jersey,NA,79428,79464,83460,242352,15705,16721,26415,58841,5408923454,8298984690,19678763647,33386671791,446945,0.1977262426348391,0.21042232960837612,0.31649892163910853,0.2427914768601043,0.26690572899848747,0.28417260073758094,0.4489216702639316
County,Pasco,Florida,NA,70666,65186,60502,196354,3204,2546,4874,10624,175393739,352638900,1430792787,1958825426,156349.5,0.04534005037783375,0.03905746632712546,0.08055932035304618,0.054106358923169375,0.3015813253012048,0.2396460843373494,0.4587725903614458
County,Salem,New Jersey,NA,6719,7070,6918,20707,1919,1648,1590,5157,180832391,209624093,282008215,672464699,124890,0.285607977377586,0.2330975954738331,0.22983521248915872,0.24904621625537257,0.37211557106845067,0.31956563893736667,0.30831878999418266
County,Union,New Jersey,NA,42962,43189,42872,129023,199,82,54,335,41549570,20870103,17994902,80414575,234549,0.004632000372422141,0.0018986315960082428,0.0012595633513715245,0.0025964362943041164,0.5940298507462687,0.24477611940298508,0.16119402985074627
County,Bergen,New Jersey,NA,82212,82734,82425,247371,1604,1690,1302,4596,491909821,674939917,699274728,1866124466,370599,0.019510533742032793,0.020426910339159235,0.015796178343949044,0.01857938076815795,0.34899912967798086,0.3677110530896432,0.283289817232376
County,Camden,Georgia,NA,4213,4261,4249,12723,269,344,852,1465,30450582,56000563,280014223,366465368,216360,0.06384998813197247,0.08073222248298521,0.2005177688867969,0.11514579894678928,0.18361774744027304,0.2348122866894198,0.5815699658703072
County,Camden,North Carolina,NA,857,843,849,2549,382,313,357,1052,56958830,65886962,115822101,238667893,212296.5,0.4457409568261377,0.37129300118623965,0.4204946996466431,0.41271086700666926,0.36311787072243346,0.2975285171102662,0.33935361216730037
County,Camden,New Jersey,NA,52049,57502,50533,160084,1226,855,628,2709,89568989,73094273,74783931,237447193,74135,0.023554727276220485,0.014869048033111891,0.012427522608988186,0.01692236575797706,0.4525655223329642,0.31561461794019935,0.23181985972683647
County,Chowan,North Carolina,NA,1561,1410,1248,4219,39,76,219,334,3732494,10746292,78711492,93190278,227126,0.024983984625240232,0.05390070921985816,0.17548076923076922,0.07916567907086987,0.11676646706586827,0.2275449101796407,0.655688622754491
County,Citrus,Florida,NA,23741,24273,23773,71787,1488,1569,3004,6061,100297812,208912010,1036095048,1345304870,173041,0.06267638262920686,0.0646397231491781,0.12636183906111975,0.08443032861102985,0.24550404223725458,0.25886817356871805,0.49562778419402737
County,Craven,North Carolina,NA,11283,11058,10253,32594,905,640,1071,2616,78066357,94402306,322905714,495374377,153072,0.08020916422937162,0.057876650388858746,0.10445723202964986,0.08026017058354298,0.3459480122324159,0.24464831804281345,0.40940366972477066
County,Harris,Texas,NA,375355,447365,312989,1135709,560,337,582,1479,53668112,56338751,215855904,325862767,172792,0.0014919209814708743,7.53299878175539e-4,0.0018594902696260891,0.0013022702118236273,0.3786342123056119,0.22785665990534146,0.3935091277890467
County,Hawaii,Hawaii,NA,19608,19781,20822,60211,50,78,191,319,20044507,49418336,275022230,344485073,480776,0.0025499796001631986,0.00394317779687579,0.009172990106618,0.0052980352427297334,0.15673981191222572,0.2445141065830721,0.5987460815047022
County,Hudson,New Jersey,NA,36262,35639,36799,108700,4411,4486,6964,15861,1961272662,3063100677,6787239150,11811612489,702421,0.12164249076167889,0.12587334100283398,0.1892442729421995,0.14591536338546457,0.27810352436794655,0.2828321039026543,0.43906437172939916
County,Iberia,Louisiana,NA,7055,6194,6294,19543,553,473,257,1283,38905055,44759196,40415291,124079542,77580,0.07838412473423104,0.07636422344204069,0.04083253892596123,0.06565010489689403,0.4310210444271239,0.3686671862821512,0.20031176929072486
County,Island,Washington,NA,12830,12831,12989,38650,453,536,2037,3026,110447824,206470109,1763595500,2080513433,584986.5,0.035307872174590804,0.04177382900787156,0.15682500577411657,0.07829236739974127,0.14970257766027759,0.17713152676801058,0.6731658955717118
County,Jasper,South Carolina,NA,3020,2811,2525,8356,28,136,167,331,3637215,20662787,71993443,96293445,169800,0.009271523178807948,0.048381358946993955,0.06613861386138614,0.03961225466730493,0.08459214501510574,0.4108761329305136,0.5045317220543807
County,Kitsap,Washington,NA,27865,27856,28119,83840,206,245,2106,2557,64568527,134453688,2076948239,2275970454,708642,0.007392786649919253,0.008795232624928203,0.07489597780859916,0.030498568702290077,0.08056315995307001,0.09581540868204928,0.8236214313648808
County,Martin,Florida,NA,21196,21028,25929,68153,1583,1929,2558,6070,315560714,610320658,2142522995,3068404367,305243,0.07468390262313644,0.09173482975080845,0.09865401673801535,0.089064311182193,0.26079077429983527,0.31779242174629324,0.4214168039538715
County,Mobile,Alabama,NA,49911,49897,49619,149427,1544,1182,1718,4444,133916568,190639144,557238901,881794613,157210,0.03093506441465809,0.02368879892578712,0.034623833612124386,0.02974027451531517,0.34743474347434744,0.265976597659766,0.3865886588658866
County,Monroe,Florida,NA,13e3,13044,13317,39361,10567,10839,11224,32630,3499999523,6060464063,14284960707,23845424293,551597.5,0.8128461538461539,0.8309567617295308,0.842832469775475,0.828993165824039,0.3238430891817346,0.332178976402084,0.3439779344161814
County,Nassau,Florida,NA,10720,10759,10755,32234,851,602,1254,2707,124237957,185943121,856753670,1166934748,334860,0.07938432835820895,0.05595315549772284,0.11659693165969316,0.08397964881801824,0.3143701514591799,0.22238640561507203,0.46324344292574804
County,Nassau,New York,NA,122880,123781,124263,370924,10312,10323,15146,35781,4358803987,5503087014,11694022443,21555913444,530295,0.08391927083333334,0.08339729037574425,0.12188664365096609,0.09646450485813805,0.28819764679578547,0.2885050725245242,0.42329728067969036
County,Nueces,Texas,NA,35673,35962,35274,106909,1784,1534,2852,6170,228525554,362700547,1155194250,1746420351,229850.5,0.05000981134191125,0.0426561370335354,0.08085275273572604,0.057712634109382745,0.28914100486223665,0.2486223662884927,0.4622366288492707
County,Onslow,North Carolina,NA,17623,19413,17989,55025,792,1123,1499,3414,117447985,274693033,637026920,1029167938,264070.5,0.044941269931339727,0.05784783392571988,0.08332870087275557,0.062044525215811,0.23198594024604569,0.3289396602226128,0.43907439953134153
County,Orange,California,NA,242939,243076,254672,740687,6595,12817,9594,29006,4026400993,11838044667,14135417562,29999863222,842905,0.027146732307287015,0.052728364791258704,0.03767198592699629,0.039160941126278714,0.22736675170654347,0.4418740950148245,0.33075915327863203
County,Orange,Texas,NA,12706,11589,8461,32756,1030,752,565,2347,63586444,79793664,101992033,245372141,76708,0.08106406422162758,0.06488911899214772,0.06677697671670016,0.07165099523751374,0.4388581167447806,0.3204090328078398,0.24073285044737963
County,Pender,North Carolina,NA,7552,8308,7520,23380,1003,979,1058,3040,249893703,352228835,590464036,1192586574,355522.5,0.1328125,0.11783822821376987,0.14069148936170212,0.1300256629597947,0.3299342105263158,0.32203947368421054,0.3480263157894737
County,Pierce,Washington,NA,84406,90098,91945,266449,204,163,1067,1434,49976815,63916293,844671558,958564666,545793.5,0.0024168897945643676,0.0018091411574063798,0.011604763717439773,0.005381892970136875,0.14225941422594143,0.11366806136680614,0.7440725244072525
County,Putnam,Florida,NA,11932,11066,11091,34089,233,649,1291,2173,10648661,56917850,278230444,345796955,128028,0.019527321488434463,0.05864811133200795,0.11640068524028492,0.06374490304790402,0.10722503451449608,0.2986654394845835,0.5941095260009204
County,Queens,New York,NA,105831,127896,70773,304500,6217,4767,1032,12016,2676366650,3478869719,1202345880,7357582249,568775.5,0.058744602243199065,0.03727247138299869,0.014581832054597092,0.03946141215106733,0.5173934753661784,0.39672103861517977,0.08588548601864181
County,Skagit,Washington,NA,14246,16267,16495,47008,358,414,714,1486,87203463,134455478,453961282,675620223,366146,0.025129861013617857,0.02545029814962808,0.04328584419521067,0.03161164057181756,0.24091520861372812,0.27860026917900405,0.48048452220726784
County,Sussex,Delaware,NA,32387,33497,32762,98646,2775,1767,2599,7141,473352115,549900288,1262745701,2285998104,293960,0.085682526939821535,0.052750992626205334,0.07932971125083939,0.07239016280437119,0.38860103626943004,0.24744433552723707,0.36395462820333285
County,Talbot,Maryland,NA,5846,5832,5847,17525,413,542,934,1889,107377478,259741016,1089839524,1456958018,551749,0.07064659596305166,0.0929355281207133,0.15974003762613306,0.1077888730385164,0.21863419798835362,0.2869242985706723,0.49444150344097404
County,Taylor,Florida,NA,2913,2880,2876,8669,161,163,599,923,8070564,15795783,156838085,180704432,145792,0.05526948163405424,0.05659722222222222,0.20827538247566063,0.10647133464067367,0.1744312026002167,0.17659804983748645,0.6489707475622969
County,Walton,Florida,NA,15806,12634,13459,41899,1187,829,926,2942,238636067,308893901,869662204,1417192172,297839.5,0.07509806402631912,0.06561659015355391,0.0688015454342819,0.07021647294684838,0.4034670292318151,0.28178110129163836,0.31475186947654654
County,Aransas,Texas,NA,4971,4563,4500,14034,529,1134,1862,3525,55728397,200314015,944678962,1200721374,242501,0.10641721987527661,0.2485207100591716,0.4137777777777778,0.25117571611799916,0.1500709219858156,0.32170212765957445,0.52822695035461
County,Baldwin,Alabama,NA,25460,25472,25459,76391,1344,1582,3324,6250,231533311,438077007,2024641742,2694252060,357251,0.05278868813825609,0.06210741206030151,0.13056286578420204,0.08181592072364545,0.21504,0.25312,0.53184
County,Brevard,Florida,NA,72809,77658,83298,233765,5890,4854,8249,18993,890816466,1376422274,5079763331,7347002071,318951,0.08089659245422956,0.06250482886502357,0.09902998871521525,0.08124826214360575,0.3101142526193861,0.2555678407834465,0.4343179065971674
County,Bristol,Massachusetts,NA,48138,48124,47836,144098,509,339,740,1588,104214509,97519657,492292439,694026605,300147.5,0.010573767086293573,0.007044302219266894,0.015469520862948408,0.011020277866451997,0.32052896725440805,0.21347607052896725,0.4659949622166247
County,Bristol,Rhode Island,NA,5381,5509,5446,16336,293,167,255,715,63675911,61840194,191067707,316583812,336014,0.05445084556773834,0.030314031584679615,0.046823356591994124,0.043768364348677764,0.4097902097902098,0.23356643356643356,0.35664335664335667
County,Broward,Florida,NA,219128,219299,219948,658375,72341,65371,65386,203098,10442243989,17724213954,42193753599,70360211542,249187,0.33013124749005146,0.2980907345678731,0.29727935693891283,0.30848376685019935,0.3561876532511398,0.32186924538892553,0.3219431013599346
County,Calhoun,Texas,NA,2667,2716,2694,8077,76,185,294,555,9146497,28662528,102042122,139851147,183808,0.028496437945256844,0.06811487481590574,0.1091314031180401,0.06871363129874954,0.13693693693693693,0.3333333333333333,0.5297297297297298
County,Calvert,Maryland,NA,13115,13188,12895,39198,475,530,561,1566,99507682,146811138,272456342,518775162,275303,0.036218070911170415,0.04018804974218987,0.043505234587049246,0.03995101790907699,0.3033205619412516,0.3384418901660281,0.35823754789272033
County,Cameron,Louisiana,NA,675,641,438,1754,409,422,310,1141,39960181,60431439,68728168,169119788,128074,0.605925925925926,0.6583463338533542,0.7077625570776256,0.6505131128848347,0.3584574934268186,0.3698510078878177,0.27169149868536374
County,Cameron,Texas,NA,47084,37642,35503,120229,1621,1430,1223,4274,204803127,299431582,532702026,1036936735,171088.5,0.03442783111035596,0.03798947983635301,0.03444779314424133,0.03554882765389382,0.3792700046794572,0.3345811885821245,0.28614880673841836
County,Charles,Maryland,NA,19242,19748,20507,59497,98,122,162,382,21104110,33124766,102894696,157123572,289334.5,0.005093025673006964,0.006177840794004456,0.007899741551665285,0.006420491789501992,0.25654450261780104,0.3193717277486911,0.42408376963350786
County,Chatham,Georgia,NA,26975,27939,26551,81465,2386,3145,3765,9296,502762186,890311417,2220521679,3613595282,330339,0.08845227062094532,0.1125666630874405,0.14180256864148244,0.11411035413981464,0.2566695352839931,0.33831755593803786,0.405012908777969
County,Clallam,Washington,NA,9867,9860,9859,29586,54,38,213,305,9258990,10316868,116978786,136554644,421685,0.005472788081483734,0.0038539553752535496,0.021604625215539103,0.010308929899276686,0.17704918032786884,0.12459016393442623,0.6983606557377049
County,Clatsop,Oregon,NA,4745,5228,5568,15541,811,376,225,1412,169161798,101516291,91382311,362060400,237912,0.17091675447839833,0.07192042846212701,0.04040948275862069,0.09085644424425712,0.5743626062322946,0.26628895184135976,0.15934844192634562
County,Collier,Florida,NA,56141,60346,66067,182554,15516,8956,13634,38106,2833764554,3761685178,21477926663,28073376395,376892,0.27637555440765216,0.14841083087528587,0.20636626454962387,0.20873823635746136,0.4071799716580066,0.23502860441925155,0.3577914239227418
County,Douglas,Oregon,NA,13564,13546,13554,40664,339,72,36,447,32440670,9979617,8859568,51279855,98886,0.024992627543497493,0.005315222205817215,0.0026560424966799467,0.01099252409994098,0.7583892617449665,0.1610738255033557,0.08053691275167785
County,Fairfax,Virginia,NA,106439,107040,115052,328531,183,228,102,513,39321710,75672280,92771098,207765088,250134,0.0017192946194533958,0.002130044843049327,8.865556444042693e-4,0.0015614964797842517,0.3567251461988304,0.4444444444444444,0.19883040935672514
County,Flagler,Florida,NA,14729,15115,16397,46241,729,809,2082,3620,122115787,208220632,1089316340,1419652759,329640.5,0.04949419512526309,0.053522990406880584,0.1269744465450997,0.07828550420622392,0.20138121546961327,0.22348066298342542,0.5751381215469613
County,Hancock,Mississippi,NA,5212,4912,5036,15160,576,697,591,1864,43244651,83437263,143958527,270640441,117761.5,0.11051419800460476,0.14189739413680783,0.11735504368546465,0.12295514511873351,0.3090128755364807,0.3739270386266094,0.31706008583690987
County,Harford,Maryland,NA,30718,30707,30291,91716,23,121,162,306,4031285,26517081,65014555,95562921,271729,7.487466631942184e-4,0.003940469599765526,0.00534812320491235,0.003336386235771294,0.07516339869281045,0.3954248366013072,0.5294117647058824
County,Jackson,Mississippi,NA,16014,15957,15256,47227,562,585,1146,2293,33279407,59214056,290726286,383219749,125196,0.03509429249406769,0.03666102650874224,0.07511798636601992,0.04855273466449277,0.24509376362843435,0.255124291321413,0.49978194505015267
County,Liberty,Georgia,NA,5581,5528,4245,15354,140,235,58,433,15390895,40216698,17710188,73317781,149466,0.0250851101953055,0.042510853835021706,0.013663133097762074,0.02820112022925622,0.3233256351039261,0.5427251732101617,0.13394919168591224
County,Lincoln,Oregon,NA,8806,8745,8584,26135,495,211,141,847,84797137,51715846,55198014,191710997,190243,0.05621167385873268,0.024128073184676958,0.016425908667287978,0.03240864740769084,0.5844155844155844,0.24911452184179456,0.16646989374262103
County,Manatee,Florida,NA,47507,49824,47280,144611,6402,5971,6726,19099,1549382799,2506412630,5613991831,9669787260,377205,0.1347590881343802,0.11984184328837508,0.14225888324873096,0.1320715574887111,0.335200795853186,0.31263416932823707,0.3521650348185769
County,Mathews,Virginia,NA,791,770,779,2340,119,143,216,478,18626502,31079194,87160378,136866074,242252,0.1504424778761062,0.18571428571428572,0.2772785622593068,0.20427350427350427,0.2489539748953975,0.29916317991631797,0.45188284518828453
County,Newport,Rhode Island,NA,10386,10367,10379,31132,215,324,288,827,57605364,149449107,341725462,548779933,464511,0.02070094357789332,0.03125301437252821,0.027748337990172463,0.026564306822561994,0.2599758162031439,0.39177750906892383,0.3482466747279323
County,Norfolk,Massachusetts,NA,60362,61005,61368,182735,1393,1025,1016,3434,433994337,472093421,812992765,1719080523,428860,0.02307743282197409,0.01680190148348496,0.016555859731456134,0.018792240129148766,0.4056493884682586,0.29848573092603375,0.29586488060570765
County,Orleans,Louisiana,NA,32475,32301,32536,97312,46,317,161,524,5278392,70689132,65646469,141613993,248180,0.0014164742109314859,0.009813937648989196,0.0049483648881239245,0.0053847418612298584,0.08778625954198473,0.6049618320610687,0.30725190839694655
County,Pacific,Washington,NA,1462,1438,1476,4376,97,75,85,257,10165651,14062912,28374842,52603405,179054,0.06634746922024624,0.0521557719054242,0.05758807588075881,0.05872943327239488,0.377431906614786,0.2918287937743191,0.33073929961089493
County,Pamlico,North Carolina,NA,1595,1563,1412,4570,457,492,566,1515,47628650,89941541,218802590,356372781,192534,0.2865203761755486,0.31477927063339733,0.40084985835694054,0.33150984682713347,0.30165016501650166,0.32475247524752476,0.3735973597359736
County,Suffolk,Massachusetts,NA,46745,45421,45643,137809,5120,6598,13282,25e3,1921054485,3819470050,20750765246,26491289781,707741.5,0.10953043106214569,0.1452632042447326,0.2909975242643998,0.18141050294247835,0.2048,0.26392,0.53128
County,Suffolk,New York,NA,152738,152045,156175,460958,4353,4699,15155,24207,1819874318,3152201976,16614267374,21586343668,531009,0.028499783943746807,0.030905324081686343,0.09703857851768849,0.05251454579375995,0.17982401784607757,0.19411740405667782,0.6260585780972446
County,Tyrrell,North Carolina,NA,85,113,132,330,72,101,106,279,6316935,11947693,24271495,42536123,126822,0.8470588235294118,0.8938053097345132,0.803030303030303,0.8454545454545455,0.25806451612903225,0.36200716845878134,0.37992831541218636
County,Ventura,California,NA,74241,73887,74084,222212,229,40,1389,1658,114140212,40966024,1582331133,1737437369,863896,0.003084548968898587,5.413672229214882e-4,0.01874898763565682,0.007461343221788202,0.13811821471652594,0.024125452352231604,0.8377563329312424
County,Volusia,Florida,NA,64656,64553,67288,196497,8552,5749,7128,21429,946170560,1071472883,3142538776,5160182219,173074,0.13226924028705767,0.08905860300838071,0.10593270716918321,0.10905510007786379,0.3990853516263008,0.26828130104064585,0.33263334733305333
County,Wakulla,Florida,NA,4166,3924,3727,11817,331,463,624,1418,29793425,73555419,179587994,282936838,173853.5,0.07945271243398944,0.11799184505606523,0.16742688489401664,0.11999661504612,0.23342736248236953,0.32651622002820874,0.4400564174894217
County,Whatcom,Washington,NA,29239,30413,30956,90608,2033,812,1247,4092,277373356,206990203,700072400,1184435959,211919,0.06953042169704847,0.026699108933679678,0.04028298229745445,0.04516157513685326,0.49682306940371457,0.198435972629521,0.3047409579667644
County,Willacy,Texas,NA,1324,1335,1249,3908,31,43,69,143,1666115,2914559,9710553,14291227,84449,0.023413897280966767,0.03220973782771536,0.055244195356285025,0.03659160696008188,0.21678321678321677,0.3006993006993007,0.4825174825174825
County,Accomack,Virginia,NA,1715,1739,1700,5154,532,531,742,1805,83315270,109582874,226333780,419231924,224181,0.31020408163265306,0.3053479010925819,0.4364705882352941,0.3502134264648816,0.29473684210526313,0.29418282548476454,0.4110803324099723
County,Atlantic,New Jersey,NA,34185,34117,34088,102390,9116,9575,8597,27288,1839973395,2889689639,5576645885,10306308919,264441,0.26666666666666666,0.2806518744321013,0.2522001877493546,0.2665104014063873,0.3340662562298446,0.35088683670477866,0.31504690706537675
County,Beaufort,North Carolina,NA,1289,1069,1043,3401,255,201,190,646,18073010,26697811,55132688,99903509,116902.5,0.1978277734678045,0.1880261927034612,0.18216682646212848,0.18994413407821228,0.39473684210526316,0.3111455108359133,0.29411764705882354
County,Beaufort,South Carolina,NA,23101,26632,27519,77252,6632,5542,9132,21306,1252673418,2044405357,8335603618,11632682393,382465.5,0.2870871390848881,0.20809552418143587,0.3318434536138668,0.2757986848236939,0.3112738195813386,0.26011452173096783,0.42861165868769363
County,Berkeley,South Carolina,NA,19881,19934,21766,61581,136,312,1398,1846,20947865,68351504,1049373862,1138673231,468200,0.006840702177958855,0.01565165044647336,0.06422861343379582,0.02997677855182605,0.07367280606717226,0.16901408450704225,0.7573131094257854
County,Brazoria,Texas,NA,36710,38106,31551,106367,1565,1225,776,3566,167247309,204911076,208157655,580316040,138830.5,0.04263143557613729,0.03214716842491996,0.02459509999683053,0.03352543552041517,0.43886707795849694,0.34352215367358385,0.21761076836791923
County,Cape May,New Jersey,NA,26761,26768,27331,80860,15409,15577,14771,45757,5186292733,9009558233,15072365297,29268216263,442452,0.5758006053585442,0.5819261805140467,0.5404485748783433,0.5658792975513233,0.3367572174749219,0.3404287868522849,0.32281399567279323
County,Caroline,Maryland,NA,4891,4770,4806,14467,70,34,48,152,9097076,6132235,18426248,33655559,167979.5,0.01431200163565733,0.007127882599580713,0.009987515605493134,0.010506670353217668,0.4605263157894737,0.2236842105263158,0.3157894736842105
County,Carteret,North Carolina,NA,13555,13843,12927,40325,3195,3308,4650,11153,401415385,731508967,2316936951,3449861303,244691,0.23570638140907416,0.23896554215126778,0.3597122302158273,0.2765778053316801,0.2864700080695777,0.296601811171882,0.4169281807585403
County,Chambers,Texas,NA,2774,4930,5603,13307,136,189,110,435,14355649,26889809,34359572,75605030,140965,0.049026676279740444,0.038336713995943204,0.019632339817954668,0.03268956188472233,0.31264367816091954,0.43448275862068964,0.25287356321839083
County,Colleton,South Carolina,NA,5454,5273,4968,15695,545,847,643,2035,125684798,306827935,376768027,809280760,370944,0.09992665933259992,0.1606296226057273,0.12942834138486312,0.12965912711054475,0.2678132678132678,0.41621621621621624,0.31597051597051595
County,Columbia,Oregon,NA,5339,5302,4904,15545,49,52,42,143,9008519,11874878,19087505,39970902,220317,0.009177748642067803,0.00980761976612599,0.008564437194127243,0.00919909938887102,0.34265734265734266,0.36363636363636365,0.2937062937062937
County,Delaware,Pennsylvania,NA,60682,61954,59944,182580,108,130,155,393,11266307,16286820,25995546,53548673,134534,0.0017797699482548367,0.0020983310197888756,0.002585746696917123,0.002152481104173513,0.2748091603053435,0.33078880407124683,0.3944020356234097
County,Escambia,Florida,NA,36499,37248,39013,112760,160,937,3917,5014,13429112,221626487,1778557602,2013613201,354918,0.004383681744705334,0.025155713058419245,0.10040242995924435,0.04446612273855977,0.03191065017949741,0.18687674511368169,0.7812126047068209
County,Franklin,Florida,NA,2070,2322,2522,6914,132,620,865,1617,29591944,212850206,572707293,815149443,399599,0.06376811594202898,0.2670111972437554,0.3429817605075337,0.23387330054960948,0.08163265306122448,0.383426097711812,0.5349412492269635
County,Harrison,Mississippi,NA,19011,18926,19336,57273,244,336,586,1166,21424806,42954595,167121235,231500636,159698.5,0.012834674662037767,0.01775335517277819,0.03030616466694249,0.020358633212857715,0.20926243567753003,0.2881646655231561,0.5025728987993139
County,Hernando,Florida,NA,25150,25377,22049,72576,703,749,738,2190,111657288,171107106,273446771,556211165,235471,0.027952286282306164,0.02951491508058478,0.033470905710009526,0.03017526455026455,0.32100456621004564,0.34200913242009134,0.336986301369863
County,Honolulu,Hawaii,NA,87087,87035,88895,263017,15759,11788,6310,33857,5534512899,7516632479,10247130899,23298276277,501994,0.18095697406042233,0.1354397656115356,0.07098261994487878,0.128725519643217,0.4654576601589036,0.3481702454440736,0.18637209439702276
County,Humboldt,California,NA,12176,12169,12098,36443,247,224,95,566,54360124,62974813,35176621,152511558,256191.5,0.02028580814717477,0.01840742871230175,0.007852537609522234,0.015531103366901737,0.4363957597173145,0.3957597173144876,0.16784452296819788
County,McIntosh,Georgia,NA,685,702,700,2087,14,56,114,184,1309153,10596653,44377336,56283142,281473,0.020437956204379562,0.07977207977207977,0.16285714285714287,0.0881648298993771,0.07608695652173914,0.30434782608695654,0.6195652173913043
County,Monmouth,New Jersey,NA,68731,69932,69011,207674,4822,3205,3457,11484,1205452896,1425104660,3213279939,5843837495,319620.5,0.07015757081957195,0.04583023508551164,0.05009346336091348,0.05529820776794399,0.41988854057819575,0.2790839428770463,0.3010275165447579
County,New York,New York,NA,1883,24068,82095,108046,2,690,2533,3225,1068186,55726e4,9030578991,9588907177,1624442,0.0010621348911311736,0.028668771813195944,0.03085449783787076,0.029848397904596192,6.2015503875969e-4,0.21395348837209302,0.7854263565891473
County,Okaloosa,Florida,NA,25926,27480,28213,81619,904,911,1855,3670,143645494,232799218,1130612989,1507057701,316126.5,0.03486847180436627,0.03315138282387191,0.06574983163789742,0.04496502039966185,0.24632152588555858,0.24822888283378747,0.5054495912806539
County,Pinellas,Florida,NA,130251,131439,125039,386729,23463,21135,31554,76152,3700920590,5980936233,21134062495,30815919318,291823,0.1801368127691918,0.16079702371442267,0.2523532657810763,0.19691308383907077,0.30810746927198235,0.2775370312007564,0.41435549952726125
County,Plymouth,Massachusetts,NA,52725,52629,52437,157791,2564,2119,1866,6549,809521980,913655869,1486574001,3209751850,404853,0.04862968231389284,0.0402629728856714,0.0355855598146347,0.04150426830427591,0.3915101542220186,0.3235608489845778,0.28492899679340356
County,Richmond,New York,NA,77999,32519,5666,116184,1114,142,20,1276,479569140,99051427,25664752,604285319,453958.5,0.014282234387620354,0.004366677942126141,0.0035298270384751147,0.010982579356882186,0.8730407523510971,0.11128526645768025,0.01567398119122257
County,Rockland,New York,NA,23095,23057,23076,69228,50,45,106,201,14244128,17289915,93300306,124834349,434327,0.002164970772894566,0.0019516849546775384,0.004593517074016294,0.0029034494713121857,0.24875621890547264,0.22388059701492538,0.527363184079602
County,San Juan,Washington,NA,2688,2844,4705,10237,79,199,213,491,25262519,99930790,165089252,290282561,518149,0.029389880952380952,0.069971870604782,0.04527098831030818,0.04796327048940119,0.16089613034623218,0.40529531568228105,0.43380855397148677
County,Sarasota,Florida,NA,66230,64295,68870,199395,5810,4534,10301,20645,1418028279,2225574081,12132583266,15776185626,489562,0.08772459610448437,0.0705187028540322,0.14957165674459125,0.10353820306426942,0.2814240736255752,0.21961734076047468,0.4989585856139501
County,Somerset,Maryland,NA,4564,4537,4561,13662,2594,2513,2476,7583,180389250,238270565,514578033,933237848,90164,0.5683610867659947,0.5538902358386599,0.5428634071475553,0.555043185477968,0.34208097059211395,0.3313991823816432,0.3265198470262429
County,Stafford,Virginia,NA,12032,14134,16284,42450,15,65,50,130,3897418,21450085,26796708,52144211,346778.5,0.0012466755319148937,0.004598839677373709,0.0030704986489805946,0.003062426383981154,0.11538461538461539,0.5,0.38461538461538464
County,Thurston,Washington,NA,20391,32115,41917,94423,7,20,357,384,1153967,4162283,213965809,219282059,499700.5,3.4328870580157915e-4,6.227619492449011e-4,0.008516830880072525,0.0040668057570719,0.018229166666666668,0.052083333333333336,0.9296875
County,Wicomico,Maryland,NA,13059,13057,12619,38735,250,314,495,1059,23231748,39037291,141510552,203779591,138008,0.01914388544298951,0.024048403155395574,0.03922656311910611,0.027339615334968374,0.2360717658168083,0.29650613786591123,0.46742209631728043
County,Ascension,Louisiana,NA,13502,13671,13620,40793,1704,1289,1363,4356,262250523,247489571,388057218,897797312,185758,0.1262035254036439,0.094287177236486,0.1000734214390602,0.10678302649964455,0.39118457300275483,0.2959136822773186,0.31290174471992654
County,Baltimore,Maryland,NA,81135,91160,90717,263012,367,652,2684,3703,50974292,134988729,992696847,1178659868,282375,0.004523325321994207,0.007152259763053971,0.029586516308960833,0.014079205511535596,0.09910883067782879,0.17607345395625168,0.7248177153659195
County,Brunswick,North Carolina,NA,27660,24226,20442,72328,926,2129,4585,7640,251595205,751216950,2675163687,3677975842,420496,0.03347794649313088,0.08788078923470652,0.22429312200371784,0.10562990819599602,0.1212041884816754,0.2786649214659686,0.600130890052356
County,Calcasieu,Louisiana,NA,14704,14468,14905,44077,194,297,526,1017,19005235,47422178,202583538,269010951,196288,0.013193688792165398,0.02052806192977606,0.03529017108352902,0.02307325816185312,0.19075712881022616,0.2920353982300885,0.5172074729596854
County,Charlotte,Florida,NA,31124,30606,29880,91610,5175,4473,7451,17099,722303749,1139798393,3975390644,5837492786,259901,0.16627040226192005,0.14614781415408742,0.24936412315930387,0.18664992904704727,0.30264927773554007,0.26159424527750164,0.4357564769869583
County,Currituck,North Carolina,NA,2786,2833,2876,8495,984,875,956,2815,184463897,252942059,426469014,863874970,255749,0.353194544149318,0.30885986586657255,0.33240611961057026,0.33137139493819895,0.3495559502664298,0.3108348134991119,0.33960923623445827
County,Fairfield,Connecticut,NA,84535,84952,85028,254515,2326,1895,3475,7696,560871962,1210409786,6041230516,7812512264,593282.5,0.02751523037794996,0.02230671437988511,0.04086889024791833,0.03023790346345009,0.30223492723492723,0.24623180873180872,0.45153326403326405
County,Galveston,Texas,NA,36524,42251,38222,116997,4959,5475,7768,18202,739252553,1223889140,3635653894,5598795587,244177.5,0.13577373781623042,0.12958273176966226,0.20323373973104494,0.15557663871723207,0.27244258872651356,0.3007911218547412,0.42676628941874517
County,Iberville,Louisiana,NA,2338,2136,2210,6684,161,171,151,483,14286325,20496052,24459758,59242135,122462,0.0688622754491018,0.0800561797752809,0.06832579185520361,0.072262118491921,0.3333333333333333,0.35403726708074534,0.31262939958592134
County,Jefferson,Louisiana,NA,39320,39354,39073,117747,540,514,592,1646,55703433,71733631,135633595,263070659,139861.5,0.013733468972533061,0.01306093408548051,0.015151127376961072,0.013979124733538859,0.32806804374240583,0.31227217496962334,0.3596597812879708
County,Jefferson,Texas,NA,28468,28380,28334,85182,136,283,249,668,8546606,24595324,44188614,77330544,93219,0.00477729380356892,0.009971811134601832,0.008788028516976071,0.007842032354253245,0.20359281437125748,0.4236526946107784,0.3727544910179641
County,Jefferson,Washington,NA,4884,4886,4912,14682,43,89,121,253,10067643,30212602,66486871,106767116,371753,0.008804258804258804,0.018215309046254603,0.02463355048859935,0.017231984743222996,0.16996047430830039,0.35177865612648224,0.4782608695652174
County,Lafourche,Louisiana,NA,10731,10209,10326,31266,4769,3820,4327,12916,443847258,545610846,1067757805,2057215909,139792.5,0.4444133817910726,0.3741796454109119,0.4190393182258377,0.4131004925478155,0.3692319603592443,0.2957572003716321,0.33501083926912356
County,Lancaster,Virginia,NA,1746,1642,1527,4915,113,214,252,579,17102979,67122252,157680057,241905288,367110,0.06471935853379153,0.13032886723507917,0.1650294695481336,0.11780264496439471,0.19516407599309155,0.3696027633851468,0.43523316062176165
County,Matagorda,Texas,NA,4161,4252,4030,12443,195,351,434,980,20627528,58280631,117573824,196481983,179753.5,0.04686373467916366,0.08254938852304798,0.1076923076923077,0.07875914168608857,0.1989795918367347,0.35816326530612247,0.44285714285714284
County,Middlesex,Connecticut,NA,19151,19088,19250,57489,787,519,1013,2319,186803603,183399286,779302534,1149505423,371729,0.04109445981933058,0.027189857502095557,0.05262337662337662,0.04033815164640192,0.339370418283743,0.2238033635187581,0.4368262181974989
County,Middlesex,Massachusetts,NA,127503,128334,128754,384591,3632,3337,2316,9285,1650691733,2442720755,2999197829,7092610317,649929,0.028485604260291914,0.02600246232487104,0.017987790670581108,0.02414253063644235,0.39116855142703283,0.3593968766828218,0.2494345718901454
County,Middlesex,New Jersey,NA,71401,70112,72053,213566,301,244,159,704,73570246,74162567,65944259,213677072,268245.5,0.004215627232111595,0.003480146052031036,0.002206708950355988,0.0032964048584512517,0.4275568181818182,0.3465909090909091,0.22585227272727273
County,Middlesex,Virginia,NA,2190,2141,2314,6645,88,231,236,555,14798136,60315831,108016057,183130024,285604,0.04018264840182648,0.10789350770667912,0.10198789974070872,0.0835214446952596,0.15855855855855855,0.41621621621621624,0.4252252252252252
County,Nantucket,Massachusetts,NA,2931,2937,2960,8828,70,227,321,618,67723161,405454241,1321181691,1794359093,2242050.5,0.023882633913340157,0.07728975144705481,0.10844594594594595,0.0700045310376076,0.11326860841423948,0.3673139158576052,0.5194174757281553
County,New Haven,Connecticut,NA,77648,77997,78756,234401,1115,1153,2193,4461,202156647,299903373,1410746136,1912806156,298374,0.01435967442818875,0.014782619844352987,0.027845497485905837,0.01903148877351206,0.24994395875364267,0.2584622281999552,0.49159381304640215
County,Sagadahoc,Maine,NA,4198,4247,4300,12745,46,71,122,239,6616647,15802540,49006037,71425224,253692,0.01095759885659838,0.016717683070402636,0.028372093023255815,0.018752451941938014,0.19246861924686193,0.29707112970711297,0.5104602510460251
County,San Diego,California,NA,258249,258273,264439,780961,497,538,2048,3083,388765253,456554971,3529098840,4374419064,1041771,0.0019244992236175165,0.0020830671421325497,0.007744697264775619,0.003947700333307297,0.16120661693156016,0.17450535192993838,0.6642880311385014
County,Snohomish,Washington,NA,78804,79043,77446,235293,346,169,520,1035,87359151,63616008,347274413,498249572,413271,0.004390640069032029,0.0021380767430385994,0.0067143558092089975,0.004398770894161747,0.3342995169082126,0.16328502415458937,0.5024154589371981
County,Tillamook,Oregon,NA,5351,5336,5553,16240,244,158,77,479,49895297,45751072,32791085,128437454,243621,0.04559895346664175,0.029610194902548726,0.013866378534125697,0.029495073891625617,0.5093945720250522,0.3298538622129436,0.16075156576200417
County,Vermilion,Louisiana,NA,4779,4809,4644,14232,953,1213,769,2935,73619710,132087412,115994634,321701756,102260,0.19941410336890564,0.25223539197338324,0.16559000861326442,0.20622540753232152,0.32470187393526406,0.4132879045996593,0.2620102214650767
County,Wahkiakum,Washington,NA,506,531,548,1585,112,93,60,265,18416397,23285982,20188107,61890486,219806,0.22134387351778656,0.1751412429378531,0.10948905109489052,0.167192429022082,0.4226415094339623,0.35094339622641507,0.22641509433962265
County,Worcester,Maryland,NA,20248,20874,20133,61255,9804,9014,10111,28929,1447216394,2118754525,4716919380,8282890299,238421,0.48419596997234293,0.4318290696560314,0.5022103014950579,0.4722716512937719,0.33889868298247433,0.31159044557364585,0.3495108714438798
County,Assumption,Louisiana,NA,1486,1475,1451,4412,720,712,645,2077,71933141,88266849,139677425,299877415,124693,0.4845222072678331,0.48271186440677966,0.4445210199862164,0.47076155938349956,0.3466538276360135,0.34280211844005776,0.31054405392392875
County,Barnstable,Massachusetts,NA,45345,45358,45258,135961,1651,1395,3304,6350,441589254,701725378,4205784336,5349098968,588650,0.036409747491454404,0.03075532430883196,0.07300366785982589,0.04670456969277955,0.26,0.21968503937007874,0.5203149606299212
County,Burlington,New Jersey,NA,48097,49065,47686,144848,2477,787,426,3690,336168116,151075729,135023352,622267197,148285.5,0.05150009356092895,0.0160399470090696,0.008933439583944974,0.025474980669391363,0.6712737127371273,0.2132791327913279,0.11544715447154472
County,Charleston,South Carolina,NA,45654,44309,39170,129133,8587,9993,16212,34792,2695986269,5305465190,17400059665,25401511124,519644,0.1880886669295133,0.22552980207181386,0.41388817972938474,0.2694276443666607,0.24680961140492066,0.2872212002759255,0.46596918831915385
County,Cumberland,Maine,NA,30748,31009,31154,92911,138,253,413,804,27347675,94338488,241050660,362736823,456559.5,0.004488096786782881,0.008158921603405462,0.013256724658149836,0.008653442541787302,0.17164179104477612,0.31467661691542287,0.513681592039801
County,Cumberland,New Jersey,NA,14151,14322,13868,42341,630,463,489,1582,65910828,65822131,102145208,233878167,137778,0.04451982192071232,0.03232788716659685,0.0352610325930199,0.037363312156066225,0.39823008849557523,0.29266750948166875,0.309102402022756
County,Dorchester,Maryland,NA,6193,6251,6118,18562,757,1119,2145,4021,85301703,182531950,739258219,1007091872,208306,0.12223478120458582,0.17901135818269076,0.35060477280156915,0.2166253636461588,0.18826162646107933,0.2782889828400895,0.5334493906988311
County,Dorchester,South Carolina,NA,13454,16298,17687,47439,22,10,130,162,3222992,1746700,41870705,46840397,221283.5,0.0016352014270848818,6.135722174499938e-4,0.0073500310962854075,0.003414911781445646,0.13580246913580246,0.06172839506172839,0.8024691358024691
County,Georgetown,South Carolina,NA,8366,8805,10229,27400,538,790,3541,4869,81630124,198142598,2515478417,2795251139,524142,0.06430791298111403,0.08972174900624645,0.3461726463974973,0.1777007299270073,0.11049496816594784,0.16225097555966317,0.727254056274389
County,Gloucester,New Jersey,NA,31172,31385,31426,93983,586,462,530,1578,76823534,74769119,118587679,270180332,156841.5,0.018798922109585524,0.014720407838139238,0.01686501622860052,0.01679027058084973,0.37135614702154623,0.29277566539923955,0.3358681875792142
County,Gloucester,Virginia,NA,4793,4879,4690,14362,538,452,859,1849,82880216,98048110,357552796,538481122,241072,0.11224702691424995,0.09264193482270958,0.18315565031982942,0.12874251497005987,0.2909680908599243,0.24445646295294754,0.4645754461871282
County,James City,Virginia,NA,7883,9239,9541,26663,72,111,139,322,12577516,29526478,71316538,113420532,298811.5,0.009133578586832425,0.012014287260526032,0.014568703490200188,0.012076660540824364,0.2236024844720497,0.3447204968944099,0.43167701863354035
County,Livingston,Louisiana,NA,10170,11070,10506,31746,344,439,326,1109,52392467,82064416,94233357,228690240,179418,0.033824975417895774,0.03965672990063234,0.031029887683228632,0.03493353493353493,0.3101893597835888,0.3958521190261497,0.2939585211902615
County,Miami-Dade,Florida,NA,242113,247263,272697,762073,98688,72373,70582,241643,17902607454,24009009259,72138429276,114050045989,254032.5,0.4076113219860148,0.2926964406320396,0.2588293967297037,0.317086420854695,0.40840413337030246,0.299503813476906,0.2920920531527915
County,New Castle,Delaware,NA,43494,60464,70052,174010,529,356,334,1219,54571115,64114042,109122175,227807332,164936,0.01216259713983538,0.005887801005557026,0.004767886712727688,0.00700534452042986,0.4339622641509434,0.29204265791632483,0.27399507793273176
County,New London,Connecticut,NA,25700,25587,25587,76874,204,240,608,1052,74553907,113747725,458200384,646502016,511473,0.0079377431906614785,0.009379763160980185,0.023762066674483134,0.013684730858287588,0.19391634980988592,0.22813688212927757,0.5779467680608364
County,Palm Beach,Florida,NA,179209,183997,204562,567768,9949,11152,15605,36706,2044879675,4692364831,26107758966,32845003472,358363,0.05551618501302948,0.06060968385354109,0.07628494050703455,0.06464964562990518,0.2710456056230589,0.30381953903993897,0.4251348553370021
County,Pasquotank,North Carolina,NA,4032,4012,4009,12053,1690,923,1133,3746,127761989,122272087,306918624,556952700,119567,0.4191468253968254,0.23005982053838483,0.28261411823397353,0.3107939931967145,0.45114789108382275,0.24639615589962627,0.302455953016551
County,Perquimans,North Carolina,NA,998,1027,1010,3035,126,128,173,427,12595736,19378668,55741966,87716370,164348,0.12625250501002003,0.124634858812074,0.1712871287128713,0.14069192751235585,0.29508196721311475,0.2997658079625293,0.405152224824356
County,Rockingham,New Hampshire,NA,39160,39230,39345,117735,1441,779,1313,3533,258335299,331064525,1057344618,1646744442,353837,0.03679775280898876,0.019857252102982413,0.033371457618502985,0.030008068968446086,0.4078686668553637,0.22049249929238607,0.3716388338522502
County,Saint Mary,Louisiana,NA,3795,3998,3632,11425,554,674,397,1625,36092429,60481229,69242788,165816446,81791,0.14598155467720686,0.16858429214607304,0.10930616740088106,0.1422319474835886,0.34092307692307694,0.4147692307692308,0.2443076923076923
County,Santa Rosa,Florida,NA,20951,20141,18373,59465,494,699,1639,2832,73583588,164875329,776319177,1014778094,277449.5,0.023578826786310916,0.03470532744153716,0.08920698851575681,0.04762465315731943,0.17443502824858756,0.2468220338983051,0.5787429378531074
County,Tangipahoa,Louisiana,NA,9324,9122,9594,28040,60,46,47,153,7604599,7417021,11271378,26292998,155842,0.006435006435006435,0.005042753782065337,0.004898895142797582,0.005456490727532097,0.39215686274509803,0.3006535947712418,0.30718954248366015
County,Terrebonne,Louisiana,NA,10203,10630,10483,31316,6658,6651,7169,20478,659080046,946882981,1816775445,3422738472,139859,0.6525531706360874,0.6256820319849482,0.6838691214347038,0.6539149316643249,0.32512940716866884,0.3247875769118078,0.3500830159195234
County,Washington,North Carolina,NA,1062,1030,979,3071,122,148,128,398,7436956,13901553,23828868,45167377,89117,0.11487758945386065,0.1436893203883495,0.13074565883554648,0.12959947899706936,0.3065326633165829,0.37185929648241206,0.32160804020100503
County,Washington,Rhode Island,NA,16607,17334,19306,53247,334,341,1604,2279,104784083,151598544,1446403323,1702785950,614542,0.020112000963449148,0.019672320295373254,0.08308297938464726,0.04280053336338197,0.1465555068012286,0.14962702939885913,0.7038174637999123
County,Los Angeles,California,NA,641100,642813,671008,1954921,333,483,4487,5303,161744280,466427084,6918795614,7546966978,1094659,5.194197473093121e-4,7.513849284317523e-4,0.006686954551957652,0.0027126415850052253,0.06279464454082595,0.09108052046011691,0.8461248349990571
County,New Hanover,North Carolina,NA,29548,31726,29955,91229,2364,2360,3723,8447,704575632,1189305140,3675377494,5569258266,406239,0.08000541491809936,0.07438693815797769,0.1242864296444667,0.09259117166690417,0.2798626731383923,0.2793891322362969,0.4407481946253108
County,Northampton,Virginia,NA,535,584,568,1687,64,67,69,200,10963276,18072385,31800013,60835674,269961.5,0.11962616822429907,0.11472602739726027,0.12147887323943662,0.11855364552459988,0.32,0.335,0.345
County,Plaquemines,Louisiana,NA,1743,1835,1944,5522,7,27,69,103,744742,3996415,22949176,27690333,232239,0.004016064257028112,0.014713896457765668,0.035493827160493825,0.0186526620789569,0.06796116504854369,0.2621359223300971,0.6699029126213593
County,Queen Annes,Maryland,NA,7119,7718,7538,22375,882,755,879,2516,214201133,264026110,567987850,1046215093,338901,0.12389380530973451,0.0978232702772739,0.11660918015388698,0.11244692737430168,0.3505564387917329,0.30007949125596184,0.34936406995230523
County,Saint James,Louisiana,NA,1867,1822,1960,5649,400,358,541,1299,50857950,55909570,120470629,227238149,160896,0.21424745581146223,0.1964873765093304,0.2760204081632653,0.2299522039298991,0.30792917628945343,0.27559661277906083,0.41647421093148573
County,Saint Johns,Florida,NA,28004,28609,31588,88201,5156,6116,6946,18218,946017012,2277843073,5194629398,8418489483,355446,0.18411655477788888,0.2137788807717851,0.2198936304925921,0.20655094613439756,0.2830167965748161,0.3357119332528269,0.381271270172357
County,Saint Lucie,Florida,NA,38524,39106,39689,117319,2580,2542,3432,8554,391691822,553533187,1424229342,2369454351,225980,0.06697123870833765,0.06500281286759065,0.08647232230592859,0.07291231599314689,0.3016132803366846,0.29717091419219077,0.4012158054711246
County,Saint Marys,Maryland,NA,13480,13388,13204,40072,647,679,750,2076,133207911,195035920,365044408,693288239,295539,0.04799703264094955,0.0507170600537795,0.056800969403211145,0.05180674785386305,0.31165703275529866,0.3270712909441233,0.36127167630057805
County,Westchester,New York,NA,60287,60483,64342,185112,79,44,191,314,66299868,64401605,573313917,704015390,1650267,0.0013103985933949275,7.274771423375164e-4,0.002968512013925585,0.0016962703660486625,0.2515923566878981,0.14012738853503184,0.60828025477707
County,Anne Arundel,Maryland,NA,62253,65622,68804,196679,1021,1372,2291,4684,269826614,488725244,1723901097,2482452955,395996,0.016400816024930525,0.020907622443692663,0.033297482704493925,0.023815455640917433,0.21797608881298036,0.2929120409906063,0.48911187019641333
County,Grays Harbor,Washington,NA,11606,11751,11749,35106,4119,2450,770,7339,329665947,276081478,173411345,779158770,88327,0.35490263656729276,0.20849289422176837,0.06553749255255767,0.20905258360394235,0.5612481264477449,0.33383294726802015,0.10491892628423491
County,Hampton City,Virginia,NA,14570,14635,14611,43816,1055,2181,3607,6843,121590094,361173632,1053721226,1536484952,193896,0.07240905971173645,0.14902630679877008,0.24686879748134966,0.15617582618221654,0.15417214671927518,0.3187198597106532,0.5271079935700717
County,Hillsborough,Florida,NA,130663,132531,134538,397732,3684,2905,9254,15843,388810004,581786715,6277104956,7247701675,292808,0.028194668727949,0.021919399989436435,0.06878354070968797,0.03983335512355053,0.23253171747775042,0.18336173704475162,0.584106545477498
County,Indian River,Florida,NA,21570,21600,21837,65007,4060,1388,3408,8856,426265552,457516171,3193459334,4077241057,203898,0.18822438572090866,0.06425925925925927,0.1560653935980217,0.13623148276339472,0.458446251129178,0.15672990063233966,0.38482384823848237
County,Norfolk City,Virginia,NA,19014,19122,19075,57211,1261,1605,4147,7013,163472736,302773520,1687534357,2153780613,248352,0.06631955401283265,0.08393473486037026,0.21740498034076017,0.12258132177378477,0.17980892627976613,0.22886068729502354,0.5913303864252103
County,Philadelphia,Pennsylvania,NA,158891,158786,158876,476553,106,581,1205,1892,9133506,87741841,526165524,623040871,280543,6.671240032475093e-4,0.003659012759311274,0.0075845313326115965,0.003970177503866306,0.056025369978858354,0.3070824524312896,0.6368921775898521
County,Saint Martin,Louisiana,NA,6507,5886,2127,14520,96,163,278,537,11117013,23004941,62535597,96657551,150203,0.01475334255417243,0.027692830445124023,0.1307005171603197,0.036983471074380166,0.1787709497206704,0.30353817504655495,0.5176908752327747
County,San Patricio,Texas,NA,7751,7566,7391,22708,123,173,175,471,11947626,25172989,61139549,98260164,150745,0.01586892013933686,0.022865450700502245,0.023677445541875255,0.02074158886735952,0.2611464968152866,0.3673036093418259,0.37154989384288745
County,Suffolk City,Virginia,NA,9631,9571,9613,28815,20,74,347,441,3098514,16697765,169679105,189475384,334205,0.0020766275568476792,0.007731689478633372,0.03609695204410694,0.015304528891202498,0.045351473922902494,0.16780045351473924,0.7868480725623582
County,Isle of Wight,Virginia,NA,4362,4659,4544,13565,30,50,230,310,4792649,12284829,104292470,121369948,367444.5,0.0068775790921595595,0.010731916720326251,0.050616197183098594,0.02285293033542204,0.0967741935483871,0.16129032258064516,0.7419354838709677
County,Poquoson City,Virginia,NA,1399,1409,1410,4218,1119,1010,1003,3132,224504938,312039472,502997017,1039541427,304557,0.7998570407433881,0.716820440028389,0.7113475177304964,0.7425320056899004,0.35727969348659006,0.322477650063857,0.320242656449553
County,Saint Bernard,Louisiana,NA,3312,3282,3285,9879,9,22,91,122,762337,2627924,18093771,21484032,158608,0.002717391304347826,0.006703229737964655,0.027701674277016742,0.012349428079765159,0.07377049180327869,0.18032786885245902,0.7459016393442623
County,Saint Charles,Louisiana,NA,4139,4468,4857,13464,1328,1720,1875,4923,211200638,363592852,577494107,1152287597,220687,0.32085044696786663,0.38495971351835273,0.38604076590487957,0.36564171122994654,0.26975421490960794,0.34938045906967297,0.3808653260207191
County,Saint Tammany,Louisiana,NA,32808,30189,31534,94531,4780,2567,3049,10396,587732436,512161129,1250758984,2350652549,164814.5,0.14569617166544746,0.08503097154592733,0.09668928775290163,0.10997450571770107,0.45979222777991535,0.246921893035783,0.29328587918430166
County,Santa Barbara,California,NA,30795,30906,40837,102538,168,98,128,394,107774618,80674976,439665891,628115485,756423,0.005455431076473454,0.0031709053258267,0.003134412420109215,0.003842477910628255,0.4263959390862944,0.24873096446700507,0.3248730964467005
County,Baltimore City,Maryland,NA,67258,66634,65490,199382,0,10,903,913,0,1555784,349217731,350773515,267271,0,1.50073536032656e-4,0.013788364635822264,0.00457914957217803,0,0.01095290251916758,0.9890470974808324
County,Northumberland,Virginia,NA,989,1082,1225,3296,15,64,81,160,2905217,17061879,37101882,57068978,301356,0.015166835187057633,0.059149722735674676,0.06612244897959184,0.04854368932038835,0.09375,0.4,0.50625
County,Chesapeake City,Virginia,NA,24388,24609,24639,73636,1394,1811,1463,4668,235423643,475169235,730266142,1440859020,259349,0.05715925865179596,0.07359096265593888,0.05937740979747555,0.0633929056439785,0.2986289631533848,0.3879605826906598,0.3134104541559554
County,Jefferson Davis,Louisiana,NA,3127,2855,2151,8133,81,65,135,281,5275361,7209031,32401094,44885486,129317,0.025903421810041575,0.02276707530647986,0.06276150627615062,0.03455059633591541,0.28825622775800713,0.2313167259786477,0.4804270462633452
County,Portsmouth City,Virginia,NA,9306,9253,9232,27791,439,330,654,1423,46045025,49943015,187039916,283027956,166858,0.047173866322802495,0.035664108937641846,0.07084055459272097,0.05120362707351301,0.3085031623330991,0.23190442726633873,0.4595924104005622
County,Newport News City,Virginia,NA,15879,15650,15549,47078,373,70,258,701,39890943,13707223,128017726,181615892,140777,0.02349014421563071,0.0044728434504792336,0.01659270692649045,0.014890182250732827,0.5320970042796006,0.09985734664764621,0.3680456490727532
County,Saint John the Baptist,Louisiana,NA,4261,4125,3672,12058,1253,1299,2022,4574,115331501,171570029,390271153,677172683,146405,0.2940624266604084,0.3149090909090909,0.5506535947712419,0.3793332227566761,0.2739396589418452,0.2839965019676432,0.4420638390905116
County,Virginia Beach City,Virginia,NA,47407,47263,47331,142001,3193,2830,5796,11819,549493269,762210087,3256604345,4568307701,314858,0.06735292256417828,0.059877705604807145,0.12245674082525194,0.08323180822670263,0.2701582198155512,0.2394449615026652,0.4903968186817836
MSA,"Aberdeen, WA",Washington,"Aberdeen, WA",11606,11751,11749,35106,4119,2450,770,7339,329665947,276081478,173411345,779158770,88327,0.35490263656729276,0.20849289422176837,0.06553749255255767,0.20905258360394235,0.5612481264477449,0.33383294726802015,0.10491892628423491
MSA,"Astoria, OR",Oregon,"Astoria, OR",4745,5228,5568,15541,811,376,225,1412,169161798,101516291,91382311,362060400,237912,0.17091675447839833,0.07192042846212701,0.04040948275862069,0.09085644424425712,0.5743626062322946,0.26628895184135976,0.15934844192634562
MSA,"Egg Harbor Township, NJ",New Jersey,"Egg Harbor Township, NJ",34185,34117,34088,102390,9116,9575,8597,27288,1839973395,2889689639,5576645885,10306308919,264441,0.26666666666666666,0.2806518744321013,0.2522001877493546,0.2665104014063873,0.3340662562298446,0.35088683670477866,0.31504690706537675
MSA,"Baltimore, MD",Maryland,"Baltimore, MD",298318,312603,316502,927423,2293,2910,6919,12122,539033324,915812948,3698818080,5153664352,336801,0.007686428576217325,0.009308931776086602,0.02186084132169781,0.013070626887623015,0.18916020458670185,0.24005939613925095,0.5707803992740472
MSA,"East Falmouth, MA",Massachusetts,"East Falmouth, MA",45345,45358,45258,135961,1651,1395,3304,6350,441589254,701725378,4205784336,5349098968,588650,0.036409747491454404,0.03075532430883196,0.07300366785982589,0.04670456969277955,0.26,0.21968503937007874,0.5203149606299212
MSA,"Baton Rouge, LA",Louisiana,"Baton Rouge, LA",78815,79581,78731,237127,2214,1904,1960,6078,329549313,350841699,539256647,1219647659,180953.5,0.028091099410010784,0.023925308804865483,0.024894895276320637,0.025631834417843603,0.36426456071076013,0.31326094109904573,0.32247449819019414
MSA,"Bay City, TX",Texas,"Bay City, TX",4161,4252,4030,12443,195,351,434,980,20627528,58280631,117573824,196481983,179753.5,0.04686373467916366,0.08254938852304798,0.1076923076923077,0.07875914168608857,0.1989795918367347,0.35816326530612247,0.44285714285714284
MSA,"Beaumont, TX",Texas,"Beaumont, TX",49842,47829,44616,142287,1182,1043,817,3042,73114872,105106774,146684992,324906638,83413,0.023714939207896954,0.021806853582554516,0.018311816388739466,0.021379324885618504,0.388560157790927,0.3428665351742275,0.2685733070348455
MSA,"Bellingham, WA",Washington,"Bellingham, WA",29239,30413,30956,90608,2033,812,1247,4092,277373356,206990203,700072400,1184435959,211919,0.06953042169704847,0.026699108933679678,0.04028298229745445,0.04516157513685326,0.49682306940371457,0.198435972629521,0.3047409579667644
MSA,"Boston, MA",Massachusetts,"Boston, MA",409592,409966,410140,1229698,15948,15210,21536,52694,5591986466,8560448254,28514526942,42666961662,570168,0.038936307349752924,0.037100637613850906,0.05250889940020481,0.042851171588471314,0.3026530534785744,0.2886476638706494,0.40869928265077615
MSA,"Bremerton, WA",Washington,"Bremerton, WA",27865,27856,28119,83840,206,245,2106,2557,64568527,134453688,2076948239,2275970454,708642,0.007392786649919253,0.008795232624928203,0.07489597780859916,0.030498568702290077,0.08056315995307001,0.09581540868204928,0.8236214313648808
MSA,"Bridgeport, CT",Connecticut,"Bridgeport, CT",84535,84952,85028,254515,2326,1895,3475,7696,560871962,1210409786,6041230516,7812512264,593282.5,0.02751523037794996,0.02230671437988511,0.04086889024791833,0.03023790346345009,0.30223492723492723,0.24623180873180872,0.45153326403326405
MSA,"Brownsville, TX",Texas,"Brownsville, TX",47084,37642,35503,120229,1621,1430,1223,4274,204803127,299431582,532702026,1036936735,171088.5,0.03442783111035596,0.03798947983635301,0.03444779314424133,0.03554882765389382,0.3792700046794572,0.3345811885821245,0.28614880673841836
MSA,"Brunswick, GA",Georgia,"Brunswick, GA",14827,14885,15532,45244,2532,2924,4670,10126,579967241,1273700994,3395778793,5249447028,291962.5,0.1707695420516625,0.19643936849177024,0.30066958537213495,0.2238086818141632,0.25004937783922576,0.28876160379221805,0.4611890183685562
MSA,"Cambridge, MD",Maryland,"Cambridge, MD",6193,6251,6118,18562,757,1119,2145,4021,85301703,182531950,739258219,1007091872,208306,0.12223478120458582,0.17901135818269076,0.35060477280156915,0.2166253636461588,0.18826162646107933,0.2782889828400895,0.5334493906988311
MSA,"Fort Myers, FL",Florida,"Fort Myers, FL",106331,106576,106924,319831,17339,14787,21199,53325,3510683061,5538566638,16304273276,25353522975,327242,0.1630662741815651,0.13874605915027774,0.19826231715985185,0.16672867858337684,0.3251570557899672,0.27729957805907174,0.3975433661509611
MSA,"Charleston, SC",South Carolina,"Charleston, SC",78989,80541,78623,238153,8745,10315,17740,36800,2720157126,5375563394,18491304232,26587024752,516663,0.11071161807340263,0.12807141704225178,0.2256337204126019,0.15452251283838542,0.2376358695652174,0.28029891304347826,0.48206521739130437
MSA,"Coos Bay, OR",Oregon,"Coos Bay, OR",6590,6598,6609,19797,180,127,167,474,23494389,23937672,49465458,96897519,181966.5,0.027314112291350532,0.01924825704759018,0.0252685731578151,0.023943021669949993,0.379746835443038,0.2679324894514768,0.35232067510548526
MSA,"Corpus Christi, TX",Texas,"Corpus Christi, TX",48395,48091,47165,143651,2436,2841,4889,10166,296201577,588187551,2161012761,3045401889,229831,0.05033577848951338,0.059075502692811546,0.1036573730520513,0.07076873812225463,0.2396222703128074,0.2794609482589022,0.48091678142829036
MSA,"Fairhope, AL",Alabama,"Fairhope, AL",25460,25472,25459,76391,1344,1582,3324,6250,231533311,438077007,2024641742,2694252060,357251,0.05278868813825609,0.06210741206030151,0.13056286578420204,0.08181592072364545,0.21504,0.25312,0.53184
MSA,"Palm Coast, FL",Florida,"Palm Coast, FL",79385,79668,83685,242738,9281,6558,9210,25049,1068286347,1279693515,4231855116,6579834978,186800,0.11691125527492599,0.08231661394788371,0.11005556551353289,0.10319356672626454,0.37051379296578707,0.26180685855722785,0.36767934847698514
MSA,"Dover, DE",Delaware,"Dover, DE",27102,33612,25169,85883,801,451,353,1605,87967191,73929649,126144656,288041496,131933,0.029555014390081912,0.013417826966559562,0.014025189717509635,0.018688215362760965,0.49906542056074765,0.2809968847352025,0.21993769470404984
MSA,"Easton, MD",Maryland,"Easton, MD",5846,5832,5847,17525,413,542,934,1889,107377478,259741016,1089839524,1456958018,551749,0.07064659596305166,0.0929355281207133,0.15974003762613306,0.1077888730385164,0.21863419798835362,0.2869242985706723,0.49444150344097404
MSA,"Elizabeth City, NC",North Carolina,"Elizabeth City, NC",5887,5882,5868,17637,2198,1364,1663,5225,197316555,207537717,478482691,883336963,138246,0.3733650416171225,0.2318939136348181,0.2834014996591684,0.2962521970856722,0.42066985645933014,0.26105263157894737,0.3182775119617225
MSA,"Eureka, CA",California,"Eureka, CA",12176,12169,12098,36443,247,224,95,566,54360124,62974813,35176621,152511558,256191.5,0.02028580814717477,0.01840742871230175,0.007852537609522234,0.015531103366901737,0.4363957597173145,0.3957597173144876,0.16784452296819788
MSA,"Georgetown, SC",South Carolina,"Georgetown, SC",8366,8805,10229,27400,538,790,3541,4869,81630124,198142598,2515478417,2795251139,524142,0.06430791298111403,0.08972174900624645,0.3461726463974973,0.1777007299270073,0.11049496816594784,0.16225097555966317,0.727254056274389
MSA,"Greenville, NC",North Carolina,"Greenville, NC",22042,19844,18836,60722,71,34,23,128,6492558,4484984,6786239,17763781,99179.5,0.0032211233100444604,0.0017133642410804273,0.0012210660437460183,0.0021079674582523632,0.5546875,0.265625,0.1796875
MSA,"Gulfport, MS",Mississippi,"Gulfport, MS",40237,39795,39628,119660,1382,1618,2323,5323,97948864,185605914,601806048,885360826,129376,0.03434649700524393,0.04065837416760899,0.058620167558292115,0.0444843723884339,0.2596280293067819,0.30396393011459705,0.4364080405786211
MSA,"Hammond, LA",Louisiana,"Hammond, LA",9324,9122,9594,28040,60,46,47,153,7604599,7417021,11271378,26292998,155842,0.006435006435006435,0.005042753782065337,0.004898895142797582,0.005456490727532097,0.39215686274509803,0.3006535947712418,0.30718954248366015
MSA,"Hartford, CT",Connecticut,"Hartford, CT",111760,112036,112404,336200,788,519,1013,2320,187004196,183399286,779302534,1149706016,371678.5,0.007050823192555476,0.0046324395729943945,0.009012134799473328,0.006900654372397383,0.3396551724137931,0.22370689655172413,0.4366379310344828
MSA,"Hilo, HI",Hawaii,"Hilo, HI",19608,19781,20822,60211,50,78,191,319,20044507,49418336,275022230,344485073,480776,0.0025499796001631986,0.00394317779687579,0.009172990106618,0.0052980352427297334,0.15673981191222572,0.2445141065830721,0.5987460815047022
MSA,"Bluffton, SC",South Carolina,"Bluffton, SC",26121,29443,30044,85608,6660,5678,9299,21637,1256310633,2065068144,8407597061,11728975838,378187,0.2549672677156311,0.19284719627755323,0.3095127146851285,0.2527450705541538,0.3078060729306281,0.26242085316818414,0.4297730739011878
MSA,"Hinesville, GA",Georgia,"Hinesville, GA",6659,6593,5510,18762,141,237,58,436,15482909,40440663,17710188,73633760,148840.5,0.02117435050307854,0.03594721674503261,0.010526315789473684,0.02323846071847351,0.32339449541284404,0.5435779816513762,0.13302752293577982
MSA,"Inverness, FL",Florida,"Inverness, FL",23741,24273,23773,71787,1488,1569,3004,6061,100297812,208912010,1036095048,1345304870,173041,0.06267638262920686,0.0646397231491781,0.12636183906111975,0.08443032861102985,0.24550404223725458,0.25886817356871805,0.49562778419402737
MSA,"Houma, LA",Louisiana,"Houma, LA",20934,20839,20809,62582,11427,10471,11496,33394,1102927304,1492493827,2884533250,5479954381,139836,0.5458584121524792,0.5024713277988387,0.5524532654140035,0.5336039116678917,0.3421872192609451,0.3135593220338983,0.3442534587051566
MSA,"Houston, TX",Texas,"Houston, TX",574971,671162,535743,1781876,7220,7226,9236,23682,974523623,1512028776,4094027025,6580579424,219237.5,0.012557155056515893,0.010766402150300523,0.017239609290275376,0.013290487104602115,0.3048728992483743,0.3051262562283591,0.3900008445232666
MSA,"Jacksonville, FL",Florida,"Jacksonville, FL",161060,162964,163667,487691,9717,10353,17392,37462,1524957756,3249140285,10351092092,15125190133,306025.5,0.06033155345833851,0.0635293684494735,0.10626454935936994,0.07681503246932997,0.2593828412791629,0.2763600448454434,0.46425711387539376
MSA,"Jacksonville, NC",North Carolina,"Jacksonville, NC",17623,19413,17989,55025,792,1123,1499,3414,117447985,274693033,637026920,1029167938,264070.5,0.044941269931339727,0.05784783392571988,0.08332870087275557,0.062044525215811,0.23198594024604569,0.3289396602226128,0.43907439953134153
MSA,"Wailuku, HI",Hawaii,"Wailuku, HI",17581,17538,19929,55048,396,439,324,1159,105264368,214124568,277843038,597231974,389965,0.022524316022979354,0.02503136047439845,0.016257714887851875,0.021054352565034153,0.34167385677308026,0.3787748058671268,0.27955133735979293
MSA,"Kapaa, HI",Hawaii,"Kapaa, HI",8442,8406,9751,26599,511,231,376,1118,201284143,177754402,547785060,926823605,508299.5,0.06053067993366501,0.027480371163454677,0.038560147677161316,0.042031655325388176,0.45706618962432916,0.20661896243291591,0.3363148479427549
MSA,"Key West, FL",Florida,"Key West, FL",13e3,13044,13317,39361,10567,10839,11224,32630,3499999523,6060464063,14284960707,23845424293,551597.5,0.8128461538461539,0.8309567617295308,0.842832469775475,0.828993165824039,0.3238430891817346,0.332178976402084,0.3439779344161814
MSA,"Kill Devil Hills, NC",North Carolina,"Kill Devil Hills, NC",3194,3213,3486,9893,1461,1584,1891,4936,298625272,439215362,912889865,1650730499,280409,0.4574201628052599,0.49299719887955185,0.5424555364314401,0.49893864348529265,0.29598865478119935,0.3209076175040519,0.38310372771474877
MSA,"Lafayette, LA",Louisiana,"Lafayette, LA",48239,46583,43273,138095,1652,1862,1316,4830,127553702,201653477,225189675,554396854,102634.5,0.03424614938120608,0.03997166348238628,0.030411573036304394,0.03497592237227995,0.34202898550724636,0.3855072463768116,0.27246376811594203
MSA,"Lake Charles, LA",Louisiana,"Lake Charles, LA",15379,15109,15343,45831,603,719,836,2158,58965416,107853617,271311706,438130739,152322.5,0.03920931139866051,0.04758753061089417,0.054487388385583,0.047086033470794875,0.2794253938832252,0.33317886932344765,0.38739573679332717
MSA,"Miami, FL",Florida,"Miami, FL",640450,650559,697207,1988216,180978,148896,151573,481447,30389731118,46425588044,140439941841,217255261003,256939.5,0.28257943633382776,0.22887393764439506,0.21740028427712285,0.24215024926869114,0.3759043051467763,0.30926768678587674,0.31482800806734695
MSA,"Mobile, AL",Alabama,"Mobile, AL",49911,49897,49619,149427,1544,1182,1718,4444,133916568,190639144,557238901,881794613,157210,0.03093506441465809,0.02368879892578712,0.034623833612124386,0.02974027451531517,0.34743474347434744,0.265976597659766,0.3865886588658866
MSA,"Morehead City, NC",North Carolina,"Morehead City, NC",13555,13843,12927,40325,3195,3308,4650,11153,401415385,731508967,2316936951,3449861303,244691,0.23570638140907416,0.23896554215126778,0.3597122302158273,0.2765778053316801,0.2864700080695777,0.296601811171882,0.4169281807585403
MSA,"Morgan City, LA",Louisiana,"Morgan City, LA",3795,3998,3632,11425,554,674,397,1625,36092429,60481229,69242788,165816446,81791,0.14598155467720686,0.16858429214607304,0.10930616740088106,0.1422319474835886,0.34092307692307694,0.4147692307692308,0.2443076923076923
MSA,"Mount Vernon, WA",Washington,"Mount Vernon, WA",14246,16267,16495,47008,358,414,714,1486,87203463,134455478,453961282,675620223,366146,0.025129861013617857,0.02545029814962808,0.04328584419521067,0.03161164057181756,0.24091520861372812,0.27860026917900405,0.48048452220726784
MSA,"Conway, SC",South Carolina,"Conway, SC",78889,81449,63465,223803,2563,4133,8098,14794,452364432,1167583606,4193908918,5813856956,339413,0.032488686635652624,0.050743409986617395,0.12759788860001575,0.06610277788948316,0.17324591050425847,0.2793700148708936,0.547384074624848
MSA,"Naples, FL",Florida,"Naples, FL",56141,60346,66067,182554,15516,8956,13634,38106,2833764554,3761685178,21477926663,28073376395,376892,0.27637555440765216,0.14841083087528587,0.20636626454962387,0.20873823635746136,0.4071799716580066,0.23502860441925155,0.3577914239227418
MSA,"New Bern, NC",North Carolina,"New Bern, NC",13637,13409,12440,39486,1364,1138,1645,4147,125891087,185274211,544229175,855394473,163643,0.10002199897338124,0.08486837198896263,0.1322347266881029,0.10502456566884466,0.32891246684350134,0.2744152399324813,0.39667229322401737
MSA,"New Haven, CT",Connecticut,"New Haven, CT",77648,77997,78756,234401,1115,1153,2193,4461,202156647,299903373,1410746136,1912806156,298374,0.01435967442818875,0.014782619844352987,0.027845497485905837,0.01903148877351206,0.24994395875364267,0.2584622281999552,0.49159381304640215
MSA,"New Orleans, LA",Louisiana,"New Orleans, LA",119925,117376,118861,356162,8363,6824,8400,23587,1027611429,1252280682,2581317884,4861209995,168975,0.06973525119866583,0.05813794983642312,0.07067078352024633,0.06622548166283881,0.35455971509729933,0.2893119091024717,0.35612837580022894
MSA,"New York, NY",New York,"New York, NY",1305769,1311164,1328749,3945682,54980,50302,74985,180267,21310337631,28659845778,73270969074,123241152483,515779,0.042105456631303086,0.038364384623128765,0.05643278000585513,0.04568715877255187,0.3049920395857256,0.2790416437839427,0.4159663166303317
MSA,"Norwich, CT",Connecticut,"Norwich, CT",25700,25587,25587,76874,204,240,608,1052,74553907,113747725,458200384,646502016,511473,0.0079377431906614785,0.009379763160980185,0.023762066674483134,0.013684730858287588,0.19391634980988592,0.22813688212927757,0.5779467680608364
MSA,"Oak Harbor, WA",Washington,"Oak Harbor, WA",12830,12831,12989,38650,453,536,2037,3026,110447824,206470109,1763595500,2080513433,584986.5,0.035307872174590804,0.04177382900787156,0.15682500577411657,0.07829236739974127,0.14970257766027759,0.17713152676801058,0.6731658955717118
MSA,"Upper Township, NJ",New Jersey,"Upper Township, NJ",26761,26768,27331,80860,15409,15577,14771,45757,5186292733,9009558233,15072365297,29268216263,442452,0.5758006053585442,0.5819261805140467,0.5404485748783433,0.5658792975513233,0.3367572174749219,0.3404287868522849,0.32281399567279323
MSA,"Olympia, WA",Washington,"Olympia, WA",20391,32115,41917,94423,7,20,357,384,1153967,4162283,213965809,219282059,499700.5,3.4328870580157915e-4,6.227619492449011e-4,0.008516830880072525,0.0040668057570719,0.018229166666666668,0.052083333333333336,0.9296875
MSA,"Oxnard, CA",California,"Oxnard, CA",74241,73887,74084,222212,229,40,1389,1658,114140212,40966024,1582331133,1737437369,863896,0.003084548968898587,5.413672229214882e-4,0.01874898763565682,0.007461343221788202,0.13811821471652594,0.024125452352231604,0.8377563329312424
MSA,"Palatka, FL",Florida,"Palatka, FL",11932,11066,11091,34089,233,649,1291,2173,10648661,56917850,278230444,345796955,128028,0.019527321488434463,0.05864811133200795,0.11640068524028492,0.06374490304790402,0.10722503451449608,0.2986654394845835,0.5941095260009204
MSA,"Palm Bay, FL",Florida,"Palm Bay, FL",72809,77658,83298,233765,5890,4854,8249,18993,890816466,1376422274,5079763331,7347002071,318951,0.08089659245422956,0.06250482886502357,0.09902998871521525,0.08124826214360575,0.3101142526193861,0.2555678407834465,0.4343179065971674
MSA,"Panama City, FL",Florida,"Panama City, FL",31918,32404,29612,93934,1391,2150,3323,6864,154082233,430123985,1406591747,1990797965,237389,0.04358042483864904,0.06634983335390693,0.11221801972173444,0.0730725828773394,0.20265151515151514,0.3132284382284382,0.4841200466200466
MSA,"Pensacola, FL",Florida,"Pensacola, FL",57450,57389,57386,172225,654,1636,5556,7846,87012700,386501816,2554876779,3028391295,328067.5,0.011383812010443865,0.028507205213542663,0.09681803924302095,0.04555668456960372,0.08335457557991333,0.20851389242926333,0.7081315319908233
MSA,"Philadelphia, PA",Pennsylvania,"Philadelphia, PA",623467,650890,654373,1928730,7214,5112,5373,17699,801261890,738723965,1492302506,3032288361,139787,0.011570780811173647,0.007853861635606632,0.008210913347586163,0.009176504746646757,0.40759364935872083,0.28882987739420307,0.3035764732470761
MSA,"Port Angeles, WA",Washington,"Port Angeles, WA",9867,9860,9859,29586,54,38,213,305,9258990,10316868,116978786,136554644,421685,0.005472788081483734,0.0038539553752535496,0.021604625215539103,0.010308929899276686,0.17704918032786884,0.12459016393442623,0.6983606557377049
MSA,"Port Saint Lucie, FL",Florida,"Port Saint Lucie, FL",59720,60134,65618,185472,4163,4471,5990,14624,707252536,1163853845,3566752337,5437858718,255776,0.06970864032150033,0.07435061695546613,0.0912859276418056,0.07884748102139406,0.28466903719912473,0.30573030634573306,0.4096006564551422
MSA,"Portland, ME",Maine,"Portland, ME",62130,62766,65239,190135,514,852,2827,4193,95773578,277878933,2048931559,2422584070,470273,0.008272976018026719,0.013574228085269095,0.04333297567406,0.02205275199200568,0.12258526114953494,0.20319580252802288,0.6742189363224421
MSA,"Providence, RI",Rhode Island,"Providence, RI",152413,152810,152598,457821,1465,1247,3269,5981,352531078,480970730,2623151659,3456653467,428649,0.009612040967633994,0.008160460702833584,0.021422299112701347,0.013064057786776929,0.24494231733823776,0.20849356294933957,0.5465641197124227
MSA,"Port Charlotte, FL",Florida,"Port Charlotte, FL",31124,30606,29880,91610,5175,4473,7451,17099,722303749,1139798393,3975390644,5837492786,259901,0.16627040226192005,0.14614781415408742,0.24936412315930387,0.18664992904704727,0.30264927773554007,0.26159424527750164,0.4357564769869583
MSA,"Raymondville, TX",Texas,"Raymondville, TX",1324,1335,1249,3908,31,43,69,143,1666115,2914559,9710553,14291227,84449,0.023413897280966767,0.03220973782771536,0.055244195356285025,0.03659160696008188,0.21678321678321677,0.3006993006993007,0.4825174825174825
MSA,"Roseburg, OR",Oregon,"Roseburg, OR",13564,13546,13554,40664,339,72,36,447,32440670,9979617,8859568,51279855,98886,0.024992627543497493,0.005315222205817215,0.0026560424966799467,0.01099252409994098,0.7583892617449665,0.1610738255033557,0.08053691275167785
MSA,"Salisbury, MD",Maryland,"Salisbury, MD",70258,71965,70075,212298,15423,13608,15681,44712,2124189507,2945962669,6635753666,11705905842,214643,0.21951948532551452,0.18909191968317932,0.22377452729218694,0.21060961478676202,0.3449409554482018,0.30434782608695654,0.35071121846484166
MSA,"San Diego, CA",California,"San Diego, CA",258249,258273,264439,780961,497,538,2048,3083,388765253,456554971,3529098840,4374419064,1041771,0.0019244992236175165,0.0020830671421325497,0.007744697264775619,0.003947700333307297,0.16120661693156016,0.17450535192993838,0.6642880311385014
MSA,"Savannah, GA",Georgia,"Savannah, GA",35197,37779,35348,108324,2468,3395,4248,10111,515687690,948367927,2408124134,3872179751,323266,0.07011961246697161,0.08986473967018714,0.12017653049677493,0.09334034932240316,0.2440905944021363,0.33577292058154484,0.42013648501631884
MSA,"Seattle, WA",Washington,"Seattle, WA",363077,368533,374361,1105971,1247,605,3190,5042,401395452,294467870,4004029479,4699892801,616534.5,0.003434533170649752,0.0016416440318777422,0.008521186768920908,0.0045588898804760705,0.24732249107497026,0.11999206664022213,0.6326854422848076
MSA,"Vero Beach, FL",Florida,"Vero Beach, FL",21570,21600,21837,65007,4060,1388,3408,8856,426265552,457516171,3193459334,4077241057,203898,0.18822438572090866,0.06425925925925927,0.1560653935980217,0.13623148276339472,0.458446251129178,0.15672990063233966,0.38482384823848237
MSA,"Shelton, WA",Washington,"Shelton, WA",9794,9631,9806,29231,82,244,1365,1691,12602011,59296953,685872056,757771020,415872,0.008372472942617929,0.02533485619354169,0.1392004894962268,0.057849543293079266,0.04849201655824956,0.14429331756357186,0.8072146658781786
MSA,"Saint Marys, GA",Georgia,"Saint Marys, GA",4213,4261,4249,12723,269,344,852,1465,30450582,56000563,280014223,366465368,216360,0.06384998813197247,0.08073222248298521,0.2005177688867969,0.11514579894678928,0.18361774744027304,0.2348122866894198,0.5815699658703072
MSA,"Tallahassee, FL",Florida,"Tallahassee, FL",38186,38047,37895,114128,335,463,625,1423,29963562,73555419,179734880,283253861,173673,0.008772848688000838,0.012169159197834258,0.016492941021242907,0.012468456469928502,0.2354181307097681,0.3253689388615601,0.4392129304286718
MSA,"Tampa, FL",Florida,"Tampa, FL",356730,354533,342128,1053391,31054,27335,46420,104809,4376781621,7086468954,29115407009,40578657584,269367,0.08705183191769686,0.07710142638343963,0.13568021325351914,0.0994967680566855,0.29629134902536997,0.26080775505920295,0.4429008959154271
MSA,"Vineland, NJ",New Jersey,"Vineland, NJ",14151,14322,13868,42341,630,463,489,1582,65910828,65822131,102145208,233878167,137778,0.04451982192071232,0.03232788716659685,0.0352610325930199,0.037363312156066225,0.39823008849557523,0.29266750948166875,0.309102402022756
MSA,"Virginia Beach, VA",Virginia,"Virginia Beach, VA",171440,172068,171716,515224,10930,11851,19962,42743,1755158097,2808980972,8897362543,13461501612,257936,0.06375408306112926,0.06887393356115025,0.11625008735353723,0.08296003291772122,0.2557143859813303,0.27726177385770767,0.46702384016096204
MSA,"Washington, NC",North Carolina,"Washington, NC",1289,1069,1043,3401,255,201,190,646,18073010,26697811,55132688,99903509,116902.5,0.1978277734678045,0.1880261927034612,0.18216682646212848,0.18994413407821228,0.39473684210526316,0.3111455108359133,0.29411764705882354
MSA,"Washington, DC",Virginia,"Washington, DC",553851,568607,600529,1722987,817,964,948,2729,174013566,281856025,539580703,995450294,275231,0.0014751259815365505,0.0016953713197340166,0.001578608193775821,0.0015838773014538125,0.29937706119457674,0.35324294613411505,0.34737999267130815
MSA,"Wilmington, NC",North Carolina,"Wilmington, NC",37100,40034,37475,114609,3367,3339,4781,11487,954469335,1541533975,4265841530,6761844840,383067,0.09075471698113208,0.08340410650946695,0.12757838559039358,0.10022773080648116,0.2931139549055454,0.2906764168190128,0.4162096282754418
MSA,"Mechanicsville, MD",Maryland,"Mechanicsville, MD",13480,13388,13204,40072,647,679,750,2076,133207911,195035920,365044408,693288239,295539,0.04799703264094955,0.0507170600537795,0.056800969403211145,0.05180674785386305,0.31165703275529866,0.3270712909441233,0.36127167630057805
MSA,"Crestview, FL",Florida,"Crestview, FL",41732,40114,41672,123518,2091,1740,2781,6612,382281561,541693119,2000275193,2924249873,311225,0.05010543467842423,0.04337637732462482,0.06673545786139375,0.05353065949902039,0.3162431941923775,0.2631578947368421,0.4205989110707804
MSA,"Los Angeles, CA",California,"Los Angeles, CA",884039,885889,925680,2695608,6928,13300,14081,34309,4188145273,12304471751,21054213176,37546830200,858875,0.007836758333059966,0.015013167563882157,0.015211520179759744,0.012727740828785195,0.20192952286572036,0.38765338540907635,0.4104170917252033
MSA,"Lincoln City, OR",Oregon,"Lincoln City, OR",8806,8745,8584,26135,495,211,141,847,84797137,51715846,55198014,191710997,190243,0.05621167385873268,0.024128073184676958,0.016425908667287978,0.03240864740769084,0.5844155844155844,0.24911452184179456,0.16646989374262103
MSA,"Bradenton, FL",Florida,"Bradenton, FL",113737,114119,116150,344006,12212,10505,17027,39744,2967411078,4731986711,17746575097,25445972886,441224,0.10737051267397593,0.09205303236095655,0.14659492036160138,0.11553286861275676,0.30726650563607083,0.2643166264090177,0.4284168679549114
MSA,"Port Lavaca, TX",Texas,"Port Lavaca, TX",2667,2716,2694,8077,76,185,294,555,9146497,28662528,102042122,139851147,183808,0.028496437945256844,0.06811487481590574,0.1091314031180401,0.06871363129874954,0.13693693693693693,0.3333333333333333,0.5297297297297298
MSA,"Santa Maria, CA",California,"Santa Maria, CA",30795,30906,40837,102538,168,98,128,394,107774618,80674976,439665891,628115485,756423,0.005455431076473454,0.0031709053258267,0.003134412420109215,0.003842477910628255,0.4263959390862944,0.24873096446700507,0.3248730964467005
MSA,"Honolulu, HI",Hawaii,"Honolulu, HI",87087,87035,88895,263017,15759,11788,6310,33857,5534512899,7516632479,10247130899,23298276277,501994,0.18095697406042233,0.1354397656115356,0.07098261994487878,0.128725519643217,0.4654576601589036,0.3481702454440736,0.18637209439702276
MSA,"Edgartown, MA",Massachusetts,"Edgartown, MA",4635,4737,5190,14562,95,100,367,562,47319464,92244708,901500129,1041064301,1549919.5,0.020496224379719527,0.021110407430863416,0.07071290944123314,0.03859359978024997,0.16903914590747332,0.17793594306049823,0.6530249110320284
City,Absecon,New Jersey,"Egg Harbor Township, NJ",1097,1097,1097,3291,40,55,66,161,5192335,9414372,18714933,33321640,180979,0.03646308113035551,0.05013673655423884,0.0601640838650866,0.048921300516560316,0.2484472049689441,0.3416149068322981,0.40993788819875776
City,Aransas Pass,Texas,"Corpus Christi, TX",1039,1039,1040,3118,88,126,111,325,7191904,15422976,39592074,62206954,125298,0.0846968238691049,0.12127045235803657,0.10673076923076923,0.10423348300192431,0.27076923076923076,0.38769230769230767,0.3415384615384615
City,Bal Harbour,Florida,"Miami, FL",1107,1107,1108,3322,1064,592,652,2308,498509343,595262176,2990738412,4084509931,752792,0.9611562782294489,0.5347786811201445,0.5884476534296029,0.6947621914509332,0.4610051993067591,0.2564991334488735,0.2824956672443674
City,Baltimore,Maryland,"Baltimore, MD",67130,67130,67131,201391,0,19,919,938,0,2840979,358326542,361167521,267271,0,2.8303292119767615e-4,0.013689651576767813,0.004657606347850699,0,0.02025586353944563,0.9797441364605544
City,Baytown,Texas,"Houston, TX",7343,7343,7343,22029,42,29,80,151,4060799,3682895,20504836,28248530,153772,0.005719733079122974,0.003949339507013482,0.010894729674519951,0.006854600753552136,0.2781456953642384,0.19205298013245034,0.5298013245033113
City,Belle Rose,Louisiana,NA,228,228,230,686,20,64,68,152,2548834,9685286,14661605,26895725,162632.5,0.08771929824561403,0.2807017543859649,0.2956521739130435,0.22157434402332363,0.13157894736842105,0.42105263157894735,0.4473684210526316
City,Boca Grande,Florida,"Fort Myers, FL",560,560,560,1680,257,471,395,1123,230066119,681118550,1386989836,2298174505,1560138,0.4589285714285714,0.8410714285714286,0.7053571428571429,0.6684523809523809,0.2288512911843277,0.41941228851291185,0.3517364203027605
City,Bradenton Beach,Florida,"Bradenton, FL",546,518,534,1598,545,518,534,1597,143227725,201734904,404524241,749486870,381648,0.9981684981684982,1,1,0.9993742177722152,0.34126487163431435,0.32435817157169694,0.3343769567939887
City,Bridgeport,Connecticut,"Bridgeport, CT",7826,7826,7827,23479,367,78,140,585,29395060,12814261,51070325,93279646,105422,0.046894965499616664,0.009966777408637873,0.017886802095311103,0.024915882277780143,0.6273504273504273,0.13333333333333333,0.23931623931623933
City,Brookhaven,New York,"New York, NY",393,393,393,1179,81,42,91,214,25788609,15455124,70476531,111720264,364614,0.20610687022900764,0.10687022900763359,0.23155216284987276,0.181509754028838,0.37850467289719625,0.19626168224299065,0.4252336448598131
City,Buxton,North Carolina,"Kill Devil Hills, NC",60,60,60,180,31,33,39,103,5199012,8014957,18492756,31706725,251744,0.5166666666666667,0.55,0.65,0.5722222222222222,0.30097087378640774,0.32038834951456313,0.3786407766990291
City,Cambridge,Massachusetts,"Boston, MA",6808,6808,6808,20424,1459,2020,1318,4797,757519110,1650017184,2060470614,4468006908,786936,0.21430669800235017,0.29670975323149235,0.1935957696827262,0.2348707403055229,0.3041484260996456,0.42109651865749426,0.27475505524286015
City,Carpinteria,California,"Santa Maria, CA",1741,1741,1742,5224,141,85,124,350,86553878,67316164,434491539,588361581,753174,0.08098793796668581,0.048822515795519814,0.0711825487944891,0.06699846860643185,0.40285714285714286,0.24285714285714285,0.35428571428571426
City,Charleston,South Carolina,"Charleston, SC",20168,20168,20169,60505,3223,4179,8149,15551,596879094,1273545836,7000118237,8870543167,382446,0.15980761602538676,0.20720944069813566,0.4040358966731122,0.25702008098504253,0.20725355282618482,0.2687286991190277,0.5240177480547875
City,Cooper City,Florida,"Miami, FL",3641,3641,3641,10923,2332,1700,1729,5761,626704473,644288183,915291429,2186284085,367767,0.6404833836858006,0.46690469651194727,0.47486954133479814,0.5274192071775153,0.40479083492449225,0.2950876583926402,0.3001215066828676
City,Crystal River,Florida,"Inverness, FL",3065,3065,3066,9196,844,936,1667,3447,62134184,128801722,589455755,780391661,171826,0.27536704730831973,0.30538336052202286,0.5437051532941944,0.37483688560243583,0.24485059472004642,0.27154046997389036,0.48360893530606325
City,Deerfield Beach,Florida,"Miami, FL",10920,10912,10917,32749,0,168,1530,1698,0,28713907,766533406,795247313,384671.5,0,0.015395894428152493,0.14014839241549876,0.051848911417142506,0,0.0989399293286219,0.901060070671378
City,Dunedin,Florida,"Tampa, FL",5536,5536,5536,16608,492,906,968,2366,51931459,179367512,492147359,723446330,216866,0.0888728323699422,0.16365606936416185,0.17485549132947978,0.14246146435452794,0.20794590025359255,0.38292476754015214,0.4091293322062553
City,East Haven,Connecticut,"New Haven, CT",3254,3254,3255,9763,143,160,561,864,18467563,30494299,203754932,252716794,283308.5,0.0439459127228027,0.049170251997541485,0.17235023041474654,0.08849738809792072,0.16550925925925927,0.18518518518518517,0.6493055555555556
City,East Moriches,New York,"New York, NY",620,620,621,1861,13,19,85,117,4574162,7484123,71903466,83961751,589063,0.020967741935483872,0.03064516129032258,0.13687600644122383,0.06286942504030091,0.1111111111111111,0.1623931623931624,0.7264957264957265
City,East Sandwich,Massachusetts,"East Falmouth, MA",720,720,721,2161,59,22,29,110,17664361,10332174,24288810,52285345,384899.5,0.08194444444444444,0.030555555555555555,0.04022191400832178,0.05090236001850995,0.5363636363636364,0.2,0.2636363636363636
City,Egg Harbor Township,New Jersey,"Egg Harbor Township, NJ",5043,5043,5045,15131,329,335,338,1002,39824121,67917415,166137773,273879309,203975,0.06523894507237755,0.06642871306761848,0.0669970267591675,0.06622166413323641,0.3283433133732535,0.3343313373253493,0.3373253493013972
City,Elkton,Maryland,"Philadelphia, PA",5323,5323,5323,15969,12,47,95,154,2063858,9986835,41149066,53199759,316059,0.0022543678376855157,0.00882960736426827,0.01784707871501033,0.00964368463898804,0.07792207792207792,0.3051948051948052,0.6168831168831169
City,Englewood,Florida,"Port Charlotte, FL",7316,7316,7318,21950,543,605,2442,3590,64610898,135474716,1527171592,1727257206,358174,0.07422088572990705,0.0826954620010935,0.3336977316206614,0.16355353075170842,0.15125348189415042,0.16852367688022285,0.6802228412256267
City,Everett,Massachusetts,"Boston, MA",2707,2707,2708,8122,179,121,30,330,61792825,54593924,26964975,143351724,378849,0.06612486147026228,0.04469892870336165,0.011078286558345642,0.04063038660428466,0.5424242424242425,0.36666666666666664,0.09090909090909091
City,Fairhope,Alabama,"Fairhope, AL",4052,4052,4054,12158,51,101,284,436,8521147,29929260,178812382,217262789,397745,0.012586377097729516,0.024925962487660415,0.07005426739023186,0.035861161375226186,0.11697247706422019,0.231651376146789,0.6513761467889908
City,Galveston,Texas,"Houston, TX",7808,7808,7809,23425,1866,2501,4670,9037,224944023,485317693,2232845707,2943107423,253910,0.23898565573770492,0.3203125,0.5980279165065949,0.38578441835645677,0.20648445280513444,0.2767511342259599,0.5167644129689056
City,Garden City,Georgia,"Savannah, GA",622,622,622,1866,33,86,124,243,2453406,10079332,22563006,35095744,134644,0.05305466237942122,0.1382636655948553,0.19935691318327975,0.1302250803858521,0.13580246913580246,0.35390946502057613,0.5102880658436214
City,Gautier,Mississippi,"Gulfport, MS",2234,2234,2236,6704,22,86,314,422,1383441,8806834,63124426,73314701,154121.5,0.009847806624888093,0.03849597135183527,0.1404293381037567,0.06294749403341289,0.052132701421800945,0.2037914691943128,0.7440758293838863
City,Golden Beach,Florida,"Miami, FL",133,133,135,401,111,115,42,268,320620939,482187231,359228325,1162036495,3674339.5,0.8345864661654135,0.8646616541353384,0.3111111111111111,0.6683291770573566,0.4141791044776119,0.4291044776119403,0.15671641791044777
City,Goodland,Florida,"Naples, FL",79,79,81,239,78,68,75,221,14407841,18170132,42786603,75364576,255079,0.9873417721518988,0.8607594936708861,0.9259259259259259,0.9246861924686193,0.35294117647058826,0.3076923076923077,0.3393665158371041
City,Greenport,New York,"New York, NY",638,638,639,1915,36,75,120,231,16780155,40484098,165155144,222419397,623816,0.05642633228840126,0.11755485893416928,0.18779342723004694,0.1206266318537859,0.15584415584415584,0.3246753246753247,0.5194805194805194
City,Gulf Breeze,Florida,"Pensacola, FL",5119,5119,5119,15357,269,1046,2238,3553,44922747,287694032,1342279493,1674896272,427502,0.052549326040242234,0.20433678452822818,0.4371947646024614,0.23136029172364395,0.0757106670419364,0.29439909935265973,0.6298902336054039
City,Hallandale,Florida,"Miami, FL",7469,7469,7469,22407,6607,5909,5095,17611,833612505,1221401544,2357740130,4412754179,191717,0.8845896371669567,0.7911366983531932,0.682152898647744,0.7859597447226313,0.37516325024132646,0.33552893078189766,0.2893078189767759
City,Hampton,Virginia,"Virginia Beach, VA",14616,14614,14616,43846,1062,2183,3618,6863,122263368,361481777,1058430016,1542175161,193940,0.07266009852216748,0.14937730942931435,0.24753694581280788,0.1565251106144232,0.15474282383797172,0.31808247122249744,0.5271747049395308
City,Highland Beach,Florida,"Miami, FL",1339,1339,1339,4017,736,1156,371,2263,252670927,631103251,527611342,1411385520,516755,0.549663928304705,0.8633308439133682,0.2770724421209858,0.5633557381130196,0.3252319929297393,0.5108263367211666,0.16394167034909413
City,Homestead,Florida,"Miami, FL",7130,7130,7131,21391,4829,2334,2589,9752,545594427,430996753,702839194,1679430374,147707.5,0.6772791023842917,0.3273492286115007,0.36306268405553216,0.4558926651395447,0.49518047579983593,0.23933552091878588,0.26548400328137817
City,Imperial Beach,California,"San Diego, CA",1431,1431,1433,4295,127,52,132,311,53066611,25885582,94149766,173101959,500098,0.08874912648497554,0.0363382250174703,0.09211444521981857,0.07240977881257275,0.40836012861736337,0.16720257234726688,0.42443729903536975
City,Indian Rocks Beach,Florida,"Tampa, FL",1007,1007,1007,3021,897,726,594,2217,273194514,334943903,479478888,1087617305,418698,0.8907646474677259,0.7209533267130089,0.5898709036742801,0.733862959285005,0.40460081190798375,0.3274695534506089,0.2679296346414073
City,Kearny,New Jersey,"New York, NY",2388,2388,2390,7166,76,35,51,162,20285273,11116333,20940173,52341779,298718,0.031825795644891124,0.014656616415410386,0.021338912133891212,0.022606754116662017,0.4691358024691358,0.21604938271604937,0.3148148148148148
City,Key Biscayne,Florida,"Miami, FL",2298,2298,2299,6895,1692,1724,1240,4656,969543846,2101787848,4986088203,8057419897,1078038.5,0.7362924281984334,0.7502175805047868,0.5393649412788168,0.6752719361856417,0.3634020618556701,0.3702749140893471,0.2663230240549828
City,Kill Devil Hills,North Carolina,"Kill Devil Hills, NC",1054,1054,1056,3164,454,487,581,1522,86004493,121861367,218708139,426573999,257395,0.4307400379506641,0.4620493358633776,0.5501893939393939,0.48103666245259163,0.2982917214191853,0.3199737187910644,0.38173455978975035
City,Knotts Island,North Carolina,"Virginia Beach, VA",199,199,200,598,89,98,115,302,14582973,22191323,40404226,77178522,235037.5,0.4472361809045226,0.49246231155778897,0.575,0.5050167224080268,0.2947019867549669,0.32450331125827814,0.38079470198675497
City,Langley,Washington,"Oak Harbor, WA",984,984,986,2954,10,14,99,123,2464492,6743684,76303544,85511720,668760,0.01016260162601626,0.014227642276422764,0.10040567951318459,0.041638456330399455,0.08130081300813008,0.11382113821138211,0.8048780487804879
City,Leisure City,Florida,"Miami, FL",1825,1825,1827,5477,47,254,354,655,6096462,43822822,75157341,125076625,186675,0.025753424657534246,0.13917808219178082,0.19376026272577998,0.1195910169800986,0.0717557251908397,0.38778625954198476,0.5404580152671755
City,Little River,South Carolina,"Conway, SC",3239,3239,3241,9719,11,22,129,162,1167623,3454592,59936896,64559111,288484,0.0033961099104661933,0.006792219820932387,0.03980253008330762,0.016668381520732585,0.06790123456790123,0.13580246913580246,0.7962962962962963
City,Manchester,Massachusetts,"Boston, MA",651,651,653,1955,47,33,51,131,22623111,27736155,125550086,175909352,852553,0.07219662058371736,0.05069124423963134,0.0781010719754977,0.0670076726342711,0.35877862595419846,0.25190839694656486,0.3893129770992366
City,Marco Island,Florida,"Naples, FL",5865,5865,5865,17595,2919,1982,2523,7424,876362861,1219854556,3885664554,5981881971,560512,0.49769820971867007,0.3379369138959932,0.4301790281329923,0.42193805058255185,0.39318426724137934,0.26697198275862066,0.33984375
City,Massapequa Park,New York,"New York, NY",2428,2428,2429,7285,1,0,113,114,426596,0,114663719,115090315,959207.5,4.1186161449752884e-4,0,0.04652120214079868,0.01564859299931366,0.008771929824561403,0,0.9912280701754386
City,Mechanicsville,Maryland,"Mechanicsville, MD",2964,2964,2965,8893,138,59,96,293,29674862,15595075,38808384,84078321,247358,0.0465587044534413,0.0199055330634278,0.03237774030354131,0.032947261891375236,0.4709897610921502,0.20136518771331058,0.32764505119453924
City,Miami Beach,Florida,"Miami, FL",15950,15946,15949,47845,15328,10171,11645,37144,3278024769,4140000029,25944702307,33362727105,356198.5,0.9610031347962382,0.6378402107111502,0.7301398206784124,0.7763402654404848,0.4126642257161318,0.27382618996338576,0.3135095843204824
City,Miami Lakes,Florida,"Miami, FL",2939,2939,2940,8818,1836,791,976,3603,370367208,279308154,587665918,1237341280,290001,0.6247022796869683,0.26913916298060564,0.33197278911564626,0.40859605352687683,0.5095753538717736,0.2195392728281987,0.27088537330002777
City,Milton,Florida,"Pensacola, FL",7536,7536,7536,22608,89,100,615,804,7391122,13769952,186909936,208071010,226351,0.011809978768577496,0.01326963906581741,0.08160828025477707,0.03556263269639066,0.11069651741293532,0.12437810945273632,0.7649253731343284
City,Moncks Corner,South Carolina,"Charleston, SC",3988,3988,3990,11966,14,91,283,388,1779257,17631913,123445529,142856699,260787.5,0.003510531594784353,0.022818455366098295,0.07092731829573935,0.03242520474678255,0.03608247422680412,0.2345360824742268,0.729381443298969
City,Morehead City,North Carolina,"Morehead City, NC",2191,2191,2193,6575,330,308,792,1430,46487047,68969922,428064670,543521639,290854.5,0.15061615700593337,0.14057507987220447,0.36114911080711354,0.21749049429657794,0.23076923076923078,0.2153846153846154,0.5538461538461539
City,New Haven,Connecticut,"New Haven, CT",6715,6716,6714,20145,33,260,115,408,3586063,47918671,35558565,87063299,192173,0.004914370811615785,0.03871351995235259,0.017128388442061365,0.020253164556962026,0.08088235294117647,0.6372549019607843,0.2818627450980392
City,New Port Richey,Florida,"Tampa, FL",16683,16683,16684,50050,1705,1168,1823,4696,90841025,177907983,643121435,911870443,160992.5,0.10219984415273033,0.07001138883893784,0.1092663629824982,0.09382617382617382,0.36307495741056217,0.24872231686541738,0.3882027257240204
City,New Smyrna Beach,Florida,"Palm Coast, FL",4596,4596,4598,13790,1983,968,966,3917,311890669,257520548,612470654,1181881871,215011,0.4314621409921671,0.21061792863359444,0.21009134406263594,0.2840464104423495,0.506254786826653,0.24712790400816953,0.24661730916517743
City,New York,New York,"New York, NY",287776,287776,287777,863329,12957,8673,5547,27177,5808565236,6342260582,13560002270,25710828088,605168,0.04502460246858668,0.030138024018681195,0.019275341670807605,0.03147930858340216,0.47676343967325313,0.31913014681532176,0.2041064135114251
City,Newburg,Maryland,"Washington, DC",565,565,565,1695,46,63,66,175,9390177,16460582,29902877,55753636,271812,0.08141592920353982,0.11150442477876106,0.1168141592920354,0.10324483775811209,0.26285714285714284,0.36,0.37714285714285717
City,Newbury,Massachusetts,"Boston, MA",912,912,912,2736,118,103,98,319,43721309,54768220,72972082,171461611,511884,0.12938596491228072,0.11293859649122807,0.1074561403508772,0.11659356725146199,0.36990595611285265,0.322884012539185,0.3072100313479624
City,Niantic,Connecticut,"Norwich, CT",1721,1721,1723,5165,21,25,87,133,4210496,6957644,49497942,60666082,415281,0.01220220801859384,0.01452643811737362,0.05049332559489263,0.02575024201355276,0.15789473684210525,0.18796992481203006,0.6541353383458647
City,Norfolk,Virginia,"Virginia Beach, VA",19117,19117,19117,57351,1264,1601,4144,7009,163820161,301789830,1685576209,2151186200,248282,0.06611916095621698,0.08374744991368939,0.2167704137678506,0.12221234154591899,0.18033956341846197,0.2284206020830361,0.5912398344985019
City,North Charleston,South Carolina,"Charleston, SC",9125,9125,9125,27375,218,130,633,981,19961030,20288128,211843057,252092215,213824,0.02389041095890411,0.014246575342465753,0.06936986301369863,0.035835616438356165,0.2222222222222222,0.1325178389398573,0.6452599388379205
City,North Falmouth,Massachusetts,"East Falmouth, MA",832,832,834,2498,35,38,84,157,13296946,20133292,114266597,147696835,689290,0.042067307692307696,0.04567307692307692,0.10071942446043165,0.06285028022417935,0.2229299363057325,0.24203821656050956,0.535031847133758
City,North Miami,Florida,"Miami, FL",4955,4901,4929,14785,2471,1219,2450,6140,292139057,228667799,1740483714,2261290570,186779,0.4986881937436932,0.24872475005101,0.49705822682085615,0.41528576259722694,0.40244299674267103,0.1985342019543974,0.3990228013029316
City,Orange Park,Florida,"Jacksonville, FL",7444,7444,7444,22332,60,22,179,261,6673338,3693064,87401704,97768106,295638,0.008060182697474477,0.002955400322407308,0.024046211714132185,0.01168726491133799,0.22988505747126436,0.0842911877394636,0.685823754789272
City,Palm Beach Shores,Florida,"Miami, FL",275,275,275,825,17,81,93,191,4297033,37416795,94321483,136035311,534888,0.06181818181818182,0.29454545454545455,0.3381818181818182,0.2315151515151515,0.08900523560209424,0.42408376963350786,0.4869109947643979
City,Panama City Beach,Florida,"Panama City, FL",8158,8158,8160,24476,441,525,418,1384,51882999,122461421,204215089,378559509,224102.5,0.05405736700171611,0.06435400833537631,0.05122549019607843,0.056545187122078774,0.3186416184971098,0.3793352601156069,0.3020231213872832
City,Port Haywood,Virginia,"Virginia Beach, VA",54,54,56,164,35,33,46,114,4925799,6325256,16561709,27812764,197510,0.6481481481481481,0.6111111111111112,0.8214285714285714,0.6951219512195121,0.30701754385964913,0.2894736842105263,0.40350877192982454
City,Quincy,Massachusetts,"Boston, MA",7830,7830,7832,23492,1213,891,811,2915,374561547,393875308,515799823,1284236678,423924,0.15491698595146872,0.11379310344827587,0.10354954034729316,0.1240847948237698,0.41612349914236707,0.30566037735849055,0.2782161234991424
City,Riverview,Florida,"Tampa, FL",10825,10825,10827,32477,28,15,151,194,3475265,3120632,71180342,77776239,334122.5,0.002586605080831409,0.0013856812933025404,0.013946614944121178,0.0059734581396064905,0.14432989690721648,0.07731958762886598,0.7783505154639175
City,Riviera Beach,Florida,"Miami, FL",5120,5120,5120,15360,90,548,1055,1693,10998088,117271991,797204379,925474458,346604,0.017578125,0.10703125,0.2060546875,0.11022135416666666,0.05316007088009451,0.32368576491435325,0.6231541642055523
City,Rotonda West,Florida,"Port Charlotte, FL",1870,1870,1872,5612,189,145,73,407,34811300,46703329,32512543,114027172,285666,0.10106951871657754,0.07754010695187166,0.038995726495726496,0.0725231646471846,0.4643734643734644,0.35626535626535627,0.17936117936117937
City,Royal Oak,Maryland,"Easton, MD",136,136,137,409,25,68,84,177,6858282,45942439,145030113,197830834,984706,0.18382352941176472,0.5,0.6131386861313869,0.43276283618581907,0.14124293785310735,0.384180790960452,0.4745762711864407
City,Slidell,Louisiana,"New Orleans, LA",9534,9534,9536,28604,3240,1318,1576,6134,346108664,203299087,517282789,1066690540,131394.5,0.3398363750786658,0.1382420809733585,0.16526845637583892,0.21444553209341352,0.5282034561460711,0.2148679491359635,0.2569285947179654
City,Smyrna,North Carolina,"Morehead City, NC",120,120,122,362,120,120,122,362,11694491,18104472,40328682,70127645,153285.5,1,1,1,1,0.3314917127071823,0.3314917127071823,0.3370165745856354
City,South Miami,Florida,"Miami, FL",1271,1271,1273,3815,0,0,116,116,0,0,119837359,119837359,879709.5,0,0,0.09112333071484682,0.03040629095674967,0,0,1
City,Stanwood,Washington,"Seattle, WA",2653,2653,2655,7961,249,62,189,500,58610728,22722307,124204739,205537774,322517,0.0938560120618168,0.023369770071617037,0.0711864406779661,0.06280618012812461,0.498,0.124,0.378
City,Stevensville,Maryland,"Baltimore, MD",2099,2099,2101,6299,533,276,262,1071,134345130,93349738,183513740,411208608,294473,0.2539304430681277,0.13149118627918055,0.12470252260828177,0.17002698841085886,0.4976657329598506,0.25770308123249297,0.2446311858076564
City,Swanquarter,North Carolina,NA,67,67,68,202,67,67,68,202,5198261,7029363,11919454,24147078,102715,1,1,1,1,0.3316831683168317,0.3316831683168317,0.33663366336633666
City,Sweetwater,Florida,"Miami, FL",822,818,822,2462,643,587,766,1996,97713792,143135604,261976231,502825627,249338.5,0.7822384428223844,0.71760391198044,0.9318734793187348,0.8107229894394801,0.3221442885771543,0.2940881763527054,0.3837675350701403
City,Taylors Island,Maryland,"Cambridge, MD",76,76,76,228,76,76,76,228,10448168,17903310,31094713,59446191,232571.5,1,1,1,1,0.3333333333333333,0.3333333333333333,0.3333333333333333
City,Thunderbolt,Georgia,"Savannah, GA",235,235,236,706,20,48,56,124,2441758,7264188,17068764,26774710,156313.5,0.0851063829787234,0.20425531914893616,0.23728813559322035,0.17563739376770537,0.16129032258064516,0.3870967741935484,0.45161290322580644
City,Titusville,Florida,"Palm Bay, FL",7946,7946,7947,23839,52,40,276,368,3506759,5012117,105744937,114263813,323976.5,0.006544173168890007,0.005033979360684621,0.03473008682521706,0.015436889131255505,0.14130434782608695,0.10869565217391304,0.75
City,Tyaskin,Maryland,"Salisbury, MD",166,166,167,499,92,114,92,298,8291147,12483706,17263079,38037932,108528.5,0.5542168674698795,0.6867469879518072,0.5508982035928144,0.5971943887775552,0.3087248322147651,0.3825503355704698,0.3087248322147651
City,Vero Beach,Florida,"Vero Beach, FL",15848,15848,15849,47545,3706,1072,2830,7608,325715057,220303968,2083391468,2629410493,165071,0.23384654215042908,0.06764260474507824,0.1785601615243864,0.1600168261646861,0.4871188222923239,0.14090431125131442,0.37197686645636174
City,Waimea,Hawaii,"Kapaa, HI",386,386,386,1158,49,54,63,166,19099604,24841809,65673458,109614871,466556.5,0.12694300518134716,0.13989637305699482,0.16321243523316062,0.14335060449050085,0.29518072289156627,0.3253012048192771,0.3795180722891566
City,Waverly,Georgia,"Saint Marys, GA",204,204,204,612,33,29,60,122,3520370,4730496,18160033,26410899,190235,0.16176470588235295,0.14215686274509803,0.29411764705882354,0.19934640522875818,0.27049180327868855,0.23770491803278687,0.4918032786885246
City,West Cape May,New Jersey,"Upper Township, NJ",274,274,274,822,162,156,144,462,62339172,74851544,94142748,231333464,472208,0.5912408759124088,0.5693430656934306,0.5255474452554745,0.5620437956204379,0.35064935064935066,0.33766233766233766,0.3116883116883117
City,West Palm Beach,Florida,"Miami, FL",13406,13406,13406,40218,269,709,1314,2292,36044043,153125432,1381813869,1570983344,331029.5,0.020065642249738922,0.05288676711920036,0.09801581381470983,0.05698940772788304,0.11736474694589878,0.3093368237347295,0.5732984293193717
City,Weston,Florida,"Miami, FL",7437,7437,7439,22313,1349,134,102,1585,264853671,58686570,138571250,462111491,192062,0.18139034556945005,0.018018018018018018,0.013711520365640543,0.07103482274907005,0.8511041009463722,0.08454258675078864,0.06435331230283911
City,Westport,Connecticut,"Bridgeport, CT",3147,3147,3148,9442,134,203,438,775,87347487,238395669,1156449663,1482192819,1573101,0.04258023514458214,0.06450587861455355,0.13913595933926304,0.08208006778224952,0.17290322580645162,0.26193548387096777,0.5651612903225807
City,White Stone,Virginia,NA,453,453,454,1360,74,158,170,402,12199692,54464898,117411307,184075897,450941,0.16335540838852097,0.3487858719646799,0.3744493392070485,0.29558823529411765,0.18407960199004975,0.39303482587064675,0.4228855721393035
City,Woodbine,Georgia,"Saint Marys, GA",511,511,511,1533,47,48,86,181,5059596,8111649,24745343,37916588,188315,0.09197651663405088,0.09393346379647749,0.16829745596868884,0.11806914546640573,0.2596685082872928,0.26519337016574585,0.47513812154696133
City,Anacortes,Washington,"Mount Vernon, WA",3698,3698,3698,11094,39,30,243,312,11013770,12369668,197672494,221055932,648588.5,0.010546241211465657,0.008112493239588967,0.06571119524067064,0.028123309897241752,0.125,0.09615384615384616,0.7788461538461539
City,Anahuac,Texas,"Houston, TX",631,631,632,1894,121,166,82,369,11723516,22760537,23337256,57821309,130611,0.19175911251980982,0.2630744849445325,0.12974683544303797,0.19482576557550157,0.32791327913279134,0.44986449864498645,0.2222222222222222
City,Anna Maria,Florida,"Bradenton, FL",466,466,467,1399,466,466,462,1394,332289622,429806583,708853695,1470949900,923731,1,1,0.9892933618843683,0.9964260185847034,0.33428981348637016,0.33428981348637016,0.3314203730272597
City,Jeanerette,Louisiana,"Lafayette, LA",983,983,985,2951,11,68,46,125,693107,5341059,5953571,11987737,82457,0.011190233977619531,0.06917599186164802,0.046700507614213196,0.04235852253473399,0.088,0.544,0.368
City,Hardeeville,South Carolina,"Bluffton, SC",760,760,762,2282,17,88,59,164,1883589,12254006,15891310,30028905,148472.5,0.02236842105263158,0.11578947368421053,0.07742782152230972,0.07186678352322524,0.10365853658536585,0.5365853658536586,0.3597560975609756
City,Mattapoisett,Massachusetts,"Boston, MA",1035,1035,1036,3106,91,105,185,381,28003822,48644133,158128949,234776904,525142,0.08792270531400966,0.10144927536231885,0.17857142857142858,0.12266580811332904,0.2388451443569554,0.27559055118110237,0.48556430446194226
City,Maurepas,Louisiana,"Baton Rouge, LA",332,332,334,998,245,191,141,577,37205243,34608081,46195839,118009163,175237,0.7379518072289156,0.5753012048192772,0.4221556886227545,0.5781563126252505,0.4246100519930676,0.3310225303292894,0.24436741767764297
City,North Topsail Beach,North Carolina,"Jacksonville, NC",763,763,764,2290,459,593,499,1551,62720740,139335046,259308905,461364691,228744,0.601572739187418,0.7771952817824378,0.6531413612565445,0.6772925764192139,0.29593810444874274,0.38233397807865893,0.3217279174725983
City,Oak Hill,Florida,"Palm Coast, FL",463,463,463,1389,48,104,132,284,3507840,14382707,37021652,54912199,161475,0.10367170626349892,0.22462203023758098,0.28509719222462204,0.2044636429085673,0.16901408450704225,0.36619718309859156,0.4647887323943662
City,Ponce Inlet,Florida,"Palm Coast, FL",961,961,961,2883,167,183,269,619,39102177,73488622,202776639,315367438,437278,0.17377731529656607,0.19042663891779396,0.27991675338189387,0.21470690253208463,0.26978998384491115,0.2956381260096931,0.4345718901453958
City,Longport,New Jersey,"Egg Harbor Township, NJ",528,528,529,1585,527,506,480,1513,278107686,414571152,1082886756,1775565594,742051,0.9981060606060606,0.9583333333333334,0.9073724007561437,0.9545741324921135,0.34831460674157305,0.33443489755452743,0.3172504957038995
City,Swampscott,Massachusetts,"Boston, MA",1665,1665,1665,4995,48,37,36,121,17181539,17809728,37022701,72013968,463994,0.02882882882882883,0.022222222222222223,0.021621621621621623,0.024224224224224225,0.39669421487603307,0.30578512396694213,0.2975206611570248
City,Wrightsville Beach,North Carolina,"Wilmington, NC",1040,1040,1042,3122,977,906,845,2728,473873019,833782053,1435112378,2742767450,879184,0.9394230769230769,0.8711538461538462,0.8109404990403071,0.8737988468930173,0.3581378299120235,0.3321114369501466,0.3097507331378299
City,Scranton,North Carolina,NA,41,41,41,123,41,41,41,123,3063580,3906262,7771778,14741620,93197,1,1,1,1,0.3333333333333333,0.3333333333333333,0.3333333333333333
City,Rumson,New Jersey,"New York, NY",820,820,820,2460,110,152,142,404,71639289,182834731,361527185,616001205,1258684,0.13414634146341464,0.18536585365853658,0.17317073170731706,0.16422764227642275,0.2722772277227723,0.37623762376237624,0.35148514851485146
City,Gibson,Louisiana,"Houma, LA",226,226,226,678,209,206,223,638,19132956,25240526,58924824,103298306,122485,0.9247787610619469,0.911504424778761,0.9867256637168141,0.9410029498525073,0.3275862068965517,0.322884012539185,0.3495297805642633
City,Lutcher,Louisiana,"New Orleans, LA",317,317,318,952,39,18,59,116,5165422,3007244,15885764,24058430,179897.5,0.12302839116719243,0.056782334384858045,0.18553459119496854,0.12184873949579832,0.33620689655172414,0.15517241379310345,0.5086206896551724
City,Nanticoke,Maryland,"Salisbury, MD",173,173,174,520,43,45,74,162,4112703,5248350,18729820,28090873,123409.5,0.24855491329479767,0.26011560693641617,0.42528735632183906,0.31153846153846154,0.2654320987654321,0.2777777777777778,0.4567901234567901
City,Edgewater,New Jersey,"New York, NY",1103,1103,1103,3309,174,159,84,417,65963200,85727432,67537205,219227837,488421,0.15775158658204896,0.1441523118766999,0.07615593834995467,0.12601994560290117,0.4172661870503597,0.381294964028777,0.2014388489208633
City,Edisto Beach,South Carolina,NA,971,971,971,2913,714,837,746,2297,172365347,326408107,542341722,1041115176,393815,0.7353244078269825,0.8619979402677652,0.768280123583934,0.7885341572262272,0.3108402263822377,0.3643883326077492,0.32477144101001304
City,Eastpoint,Florida,NA,877,877,877,2631,87,376,409,872,23909406,166170727,375070613,565150746,575459,0.09920182440136831,0.42873432155074115,0.4663625997719498,0.3314329152413531,0.09977064220183486,0.43119266055045874,0.4690366972477064
City,Vienna,Maryland,"Cambridge, MD",243,243,245,731,42,60,65,167,3476616,7402296,19431697,30310609,126604,0.1728395061728395,0.24691358024691357,0.2653061224489796,0.22845417236662108,0.25149700598802394,0.3592814371257485,0.38922155688622756
City,Atlantic City,New Jersey,"Egg Harbor Township, NJ",3476,3476,3478,10430,2791,2585,2262,7638,240082836,325999105,570495344,1136577285,120542.5,0.8029344073647872,0.7436708860759493,0.6503737780333525,0.7323106423777564,0.36540979313956534,0.3384393820371825,0.29615082482325217
City,Bay Harbor Islands,Florida,"Miami, FL",779,781,778,2338,714,771,767,2252,154674258,231240033,1026647532,1412561823,295226,0.9165596919127086,0.9871959026888605,0.9858611825192802,0.9632164242942686,0.31705150976909413,0.34236234458259324,0.34058614564831263
City,Bayou La Batre,Alabama,"Mobile, AL",285,285,287,857,104,110,105,319,4135604,5962460,11880877,21978941,54237,0.3649122807017544,0.38596491228070173,0.36585365853658536,0.37222870478413067,0.32601880877742945,0.3448275862068966,0.329153605015674
City,Beaufort,North Carolina,"Morehead City, NC",1964,1964,1966,5894,1152,1031,1211,3394,126445078,201423584,585592814,913461476,194234,0.5865580448065173,0.524949083503055,0.615971515768057,0.5758398371224974,0.33942251031231585,0.30377136122569237,0.3568061284619917
City,Belleair Beach,Florida,"Tampa, FL",406,406,406,1218,284,258,328,870,107732019,141947466,398238543,647918028,555511,0.6995073891625616,0.6354679802955665,0.8078817733990148,0.7142857142857143,0.3264367816091954,0.296551724137931,0.37701149425287356
City,Biddeford,Maine,"Portland, ME",1888,1888,1889,5665,0,7,251,258,0,1599805,206850024,208449829,676542,0,0.003707627118644068,0.1328745367919534,0.04554280670785525,0,0.027131782945736434,0.9728682170542635
City,Blaine,Washington,"Bellingham, WA",3724,3724,3725,11173,1133,404,445,1982,132677240,97898708,215629365,446205313,169580,0.30424274973147153,0.10848549946294307,0.11946308724832215,0.17739192696679495,0.5716448032290615,0.20383451059535823,0.22452068617558021
City,Boca Raton,Florida,"Miami, FL",32075,32075,32077,96227,1111,999,1963,4073,213985628,304027314,2799657142,3317670084,384363,0.03463756819953235,0.031145752143413873,0.06119649593166443,0.04232699762021054,0.2727719125951387,0.2452737539896882,0.4819543334151731
City,Boutte,Louisiana,"New Orleans, LA",119,119,120,358,107,114,117,338,15910367,22152578,34596029,72658974,194630.5,0.8991596638655462,0.957983193277311,0.975,0.9441340782122905,0.3165680473372781,0.33727810650887574,0.34615384615384615
City,Camden,New Jersey,"Philadelphia, PA",7064,7064,7064,21192,909,677,501,2087,57504532,50449236,56605854,164559622,70500,0.12868063420158551,0.09583805209513024,0.07092298980747452,0.09848055870139676,0.4355534259702923,0.3243890752275994,0.24005749880210828
City,Cape May,New Jersey,"Upper Township, NJ",1088,1088,1088,3264,321,579,788,1688,118257252,337407071,900391939,1356056262,694557,0.29503676470588236,0.5321691176470589,0.7242647058823529,0.5171568627450981,0.1901658767772512,0.34300947867298576,0.466824644549763
City,Caswell Beach,North Carolina,"Conway, SC",197,189,194,580,0,70,90,160,0,25827030,55695919,81522949,464070.5,0,0.37037037037037035,0.4639175257731959,0.27586206896551724,0,0.4375,0.5625
City,Cedar Island,North Carolina,"Morehead City, NC",73,73,73,219,43,46,47,136,3556469,6324722,12753915,22635106,134812,0.589041095890411,0.6301369863013698,0.6438356164383562,0.6210045662100456,0.3161764705882353,0.3382352941176471,0.34558823529411764
City,Center Moriches,New York,"New York, NY",836,836,836,2508,89,89,159,337,28561601,31995939,118275040,178832580,369418,0.10645933014354067,0.10645933014354067,0.1901913875598086,0.1343700159489633,0.26409495548961426,0.26409495548961426,0.47181008902077154
City,Cocoa,Florida,"Palm Bay, FL",8120,8120,8121,24361,2,3,151,156,180445,371173,84146693,84698311,493619,2.463054187192118e-4,3.6945812807881776e-4,0.01859376924024135,0.006403678009933911,0.01282051282051282,0.019230769230769232,0.967948717948718
City,Crawfordville,Florida,"Tallahassee, FL",3174,3174,3176,9524,84,192,432,708,6770028,24346602,122058217,153174847,191964.5,0.026465028355387523,0.06049149338374291,0.13602015113350127,0.0743385132297354,0.11864406779661017,0.2711864406779661,0.6101694915254238
City,Creswell,North Carolina,NA,192,192,192,576,109,106,108,323,6682829,9522357,20042432,36247618,84781,0.5677083333333334,0.5520833333333334,0.5625,0.5607638888888888,0.33746130030959753,0.3281733746130031,0.33436532507739936
City,Darien,Connecticut,"Bridgeport, CT",2137,2137,2139,6413,9,41,194,244,8365323,66970170,813743450,889078943,2823623.5,0.004211511464670099,0.01918577445016378,0.09069658719027583,0.03804771557773273,0.036885245901639344,0.1680327868852459,0.7950819672131147
City,Davie,Florida,"Miami, FL",9559,9559,9560,28678,7205,4137,3375,14717,966672321,1180378461,2161173926,4308224708,209254,0.7537399309551208,0.43278585626111515,0.3530334728033473,0.513180835483646,0.4895698851668139,0.28110348576476185,0.22932662906842427
City,Deland,Florida,"Palm Coast, FL",7183,7183,7184,21550,32,44,97,173,3311374,7190362,34291822,44793558,226172,0.004454963107336767,0.006125574272588055,0.013502227171492204,0.00802784222737819,0.18497109826589594,0.2543352601156069,0.5606936416184971
City,Delran,New Jersey,"Philadelphia, PA",1731,1731,1731,5193,113,7,11,131,17175838,1534599,3207397,21917834,152595,0.06528018486424032,0.004043905257076834,0.006354708261120739,0.0252262661274793,0.8625954198473282,0.05343511450381679,0.08396946564885496
City,Destin,Florida,"Crestview, FL",5067,5067,5068,15202,559,332,451,1342,104464141,112644504,419882467,636991112,313365.5,0.11032168936254194,0.06552200513124136,0.08898973954222573,0.08827785817655572,0.4165424739195231,0.2473919523099851,0.3360655737704918
City,Dundalk,Maryland,"Baltimore, MD",7281,7281,7283,21845,155,118,758,1031,13661756,17154311,178899947,209716014,183911,0.021288284576294465,0.016206565032275785,0.10407798983935192,0.04719615472648203,0.15033947623666344,0.11445198836081474,0.7352085354025218
City,East Rockaway,New York,"New York, NY",1025,1025,1026,3076,625,293,430,1348,227292607,149127248,315510759,691930614,476283,0.6097560975609756,0.28585365853658534,0.4191033138401559,0.43823146944083224,0.46364985163204747,0.21735905044510387,0.3189910979228487
City,Edgewater,Maryland,"Baltimore, MD",2994,2994,2995,8983,200,289,260,749,57927503,110677319,193555494,362160316,388788,0.06680026720106881,0.09652638610554443,0.08681135225375626,0.08337971724368251,0.26702269692923897,0.38584779706275035,0.3471295060080107
City,Englewood,New Jersey,"New York, NY",2256,2256,2258,6770,263,204,21,488,73095459,79068955,12286228,164450642,317392.5,0.11657801418439716,0.09042553191489362,0.009300265721877768,0.07208271787296898,0.5389344262295082,0.4180327868852459,0.0430327868852459
City,Essex,Maryland,"Baltimore, MD",4363,4363,4363,13089,44,132,241,417,6295628,25222011,91667536,123185175,246947,0.010084804033921613,0.03025441210176484,0.055237222094888835,0.031858812743525096,0.10551558752997602,0.31654676258992803,0.5779376498800959
City,Fleming Island,Florida,"Jacksonville, FL",3335,3335,3335,10005,100,287,554,941,18826356,72870004,345165348,436861708,362086,0.029985007496251874,0.08605697151424288,0.1661169415292354,0.09405297351324338,0.10626992561105207,0.30499468650371947,0.5887353878852285
City,Franklin,Louisiana,"Morgan City, LA",1093,1093,1093,3279,415,487,341,1243,25665495,42795083,60403478,128864056,80313,0.3796889295516926,0.4455626715462031,0.3119853613906679,0.37907898749618785,0.333869670152856,0.3917940466613033,0.2743362831858407
City,Friday Harbor,Washington,NA,1502,1502,1502,4506,13,138,42,193,4911541,71095985,45475285,121482811,529399,0.008655126498002663,0.09187749667110519,0.02796271637816245,0.042831779849090104,0.06735751295336788,0.7150259067357513,0.21761658031088082
City,Fruit Cove,Florida,"Jacksonville, FL",3386,3386,3388,10160,9,19,161,189,1925299,5877129,117464869,125267297,612280,0.0026580035440047253,0.005611340815121087,0.047520661157024795,0.01860236220472441,0.047619047619047616,0.10052910052910052,0.8518518518518519
City,Gheens,Louisiana,"Houma, LA",118,118,118,354,118,118,118,354,9240608,13058031,27205109,49503748,112106.5,1,1,1,1,0.3333333333333333,0.3333333333333333,0.3333333333333333
City,Gueydan,Louisiana,"Lafayette, LA",314,314,315,943,188,192,222,602,14723954,17138493,29913246,61775693,89815,0.5987261146496815,0.6114649681528662,0.7047619047619048,0.6383881230116649,0.3122923588039867,0.31893687707641194,0.3687707641196013
City,Hackberry,Louisiana,"Lake Charles, LA",104,104,104,312,92,86,77,255,8749777,11159995,16016297,35926069,125561,0.8846153846153846,0.8269230769230769,0.7403846153846154,0.8173076923076923,0.3607843137254902,0.33725490196078434,0.30196078431372547
City,Harvey Cedars,New Jersey,"New York, NY",405,405,407,1217,391,338,216,945,275144589,363078774,392954032,1031177395,953288,0.9654320987654321,0.8345679012345679,0.5307125307125307,0.7764995891536566,0.41375661375661377,0.3576719576719577,0.22857142857142856
City,Hillsboro Beach,Florida,"Miami, FL",746,748,744,2238,82,100,25,207,25077804,38435714,22742012,86255530,340948,0.10991957104557641,0.13368983957219252,0.033602150537634407,0.09249329758713137,0.3961352657004831,0.4830917874396135,0.12077294685990338
City,Hilton Head Island,South Carolina,"Bluffton, SC",9744,9744,9746,29234,5448,4087,5326,14861,1058841581,1684769262,6053149928,8796760771,399932,0.5591133004926109,0.4194376026272578,0.5464806074286886,0.5083464459191352,0.3665971334365117,0.27501514030011437,0.35838772626337395
City,Hitchcock,Texas,"Houston, TX",996,996,998,2990,191,166,159,516,12912174,17591619,78460704,108964497,105227,0.19176706827309237,0.16666666666666666,0.1593186372745491,0.1725752508361204,0.3701550387596899,0.32170542635658916,0.3081395348837209
City,Holden Beach,North Carolina,"Conway, SC",701,701,701,2103,464,530,453,1447,142312583,233674255,339570051,715556889,430225,0.6619115549215406,0.7560627674750356,0.6462196861626248,0.6880646695197337,0.3206634416033172,0.36627505183137526,0.3130615065653075
City,Holiday,Florida,"Tampa, FL",5722,5722,5722,17166,54,84,434,572,3133713,7277966,124394097,134805776,174382.5,0.009437259699405802,0.014680181754631249,0.07584760573226144,0.03332168239543283,0.0944055944055944,0.14685314685314685,0.7587412587412588
City,Holly Hill,Florida,"Palm Coast, FL",1424,1424,1424,4272,654,528,960,2142,43301785,58427302,249131267,350860354,122327.5,0.4592696629213483,0.3707865168539326,0.6741573033707865,0.5014044943820225,0.30532212885154064,0.24649859943977592,0.4481792717086835
City,Jensen Beach,Florida,"Port Saint Lucie, FL",1799,1799,1799,5397,36,8,57,101,4752535,1843231,43553495,50149261,356089,0.020011117287381877,0.0044469149527515284,0.03168426903835464,0.018714100426162682,0.3564356435643564,0.07920792079207921,0.5643564356435643
City,Kaneohe,Hawaii,"Honolulu, HI",5149,5149,5149,15447,34,74,320,428,23034178,61937433,440428338,525399949,1085551,0.006603223926976112,0.014371722664595066,0.06214798990095164,0.027707645497507608,0.0794392523364486,0.17289719626168223,0.7476635514018691
City,Keansburg,New Jersey,"New York, NY",951,951,953,2855,778,695,606,2079,94735438,113986866,164306743,373029047,160211,0.8180862250262881,0.7308096740273397,0.6358866736621196,0.7281961471103328,0.37421837421837423,0.3342953342953343,0.29148629148629146
City,Kihei,Hawaii,"Wailuku, HI",4644,4634,4620,13898,86,208,77,371,33016873,128907434,125147242,287071549,581749,0.018518518518518517,0.044885627967198964,0.016666666666666666,0.026694488415599366,0.23180592991913745,0.5606469002695418,0.20754716981132076
City,Killian,Louisiana,"Baton Rouge, LA",163,163,164,490,65,58,75,198,10181738,12097021,20002171,42280930,211433,0.3987730061349693,0.3558282208588957,0.4573170731707317,0.40408163265306124,0.3282828282828283,0.29292929292929293,0.3787878787878788
City,La Conner,Washington,"Mount Vernon, WA",636,636,638,1910,123,192,179,494,26896264,58231188,98125849,183253301,317834,0.19339622641509435,0.3018867924528302,0.28056426332288403,0.25863874345549737,0.24898785425101214,0.38866396761133604,0.3623481781376518
City,Lantana,Florida,"Miami, FL",1381,1381,1381,4143,307,214,514,1035,37250196,42178241,720855371,800283808,227185,0.222302679217958,0.1549601737871108,0.3721940622737147,0.2498189717595945,0.2966183574879227,0.20676328502415459,0.4966183574879227
City,Largo,Florida,"Tampa, FL",9194,9194,9194,27582,94,59,525,678,7287292,8344347,263998876,279630515,314794,0.010224059169023277,0.006417228627365673,0.057102458124864044,0.024581248640417663,0.13864306784660768,0.08702064896755163,0.7743362831858407
City,Leonia,New Jersey,"New York, NY",812,812,813,2437,99,25,6,130,31704303,13023231,3913628,48641162,388420.5,0.12192118226600986,0.03078817733990148,0.007380073800738007,0.053344275748871565,0.7615384615384615,0.19230769230769232,0.046153846153846156
City,Lusby,Maryland,"Washington, DC",3443,3443,3444,10330,122,53,146,321,20198898,11876510,60412069,92487477,228916,0.03543421434795237,0.015393552134766193,0.042392566782810684,0.031074540174249758,0.38006230529595014,0.16510903426791276,0.45482866043613707
City,Madisonville,Louisiana,"New Orleans, LA",1480,1480,1482,4442,330,166,129,625,63341594,42508158,73689009,179538761,230792,0.22297297297297297,0.11216216216216217,0.08704453441295547,0.14070238631247187,0.528,0.2656,0.2064
City,Malibu,California,"Los Angeles, CA",2400,2400,2402,7202,27,86,134,247,48470765,260999228,1139409107,1448879100,5368798,0.01125,0.035833333333333335,0.05578684429641965,0.03429602888086643,0.10931174089068826,0.3481781376518219,0.5425101214574899
City,Manalapan,Florida,"Miami, FL",76,76,77,229,62,64,40,166,82125556,236421327,585087262,903634145,3294511,0.8157894736842105,0.8421052631578947,0.5194805194805194,0.7248908296943232,0.37349397590361444,0.3855421686746988,0.24096385542168675
City,Manteo,North Carolina,"Kill Devil Hills, NC",421,421,421,1263,201,187,218,606,39501904,52664928,107211819,199378651,280047,0.47743467933491684,0.44418052256532065,0.517814726840855,0.47980997624703087,0.3316831683168317,0.3085808580858086,0.35973597359735976
City,Margate City,New Jersey,"Egg Harbor Township, NJ",2187,2187,2188,6562,1997,1925,1915,5837,623893803,936868801,1962677705,3523440309,480165,0.9131229995427527,0.8802011888431641,0.8752285191956124,0.8895153916488875,0.34212780537947574,0.3297927017303409,0.3280794928901833
City,Marrero,Louisiana,"New Orleans, LA",5526,5526,5526,16578,26,51,159,236,2687567,6787419,34689496,44164482,166978,0.004705030763662686,0.009229098805646038,0.028773072747014114,0.014235734105440946,0.11016949152542373,0.21610169491525424,0.673728813559322
City,Massapequa,New York,"New York, NY",5603,5601,5604,16808,612,776,2565,3953,246663122,390507232,1924167105,2561337459,583546,0.1092271997144387,0.13854668809141224,0.45770877944325483,0.23518562589243217,0.15481912471540601,0.19630660258031873,0.6488742727042752
City,Miami,Florida,"Miami, FL",35967,35967,35968,107902,10122,11284,11468,32874,1716502594,3492725303,10771750201,15980978098,309216.5,0.28142463925264827,0.3137320321405733,0.3188389679715303,0.3046653444792497,0.3079029019894141,0.34324998479041186,0.348847113220174
City,Milford,Connecticut,"New Haven, CT",6081,6081,6081,18243,393,369,693,1455,78790695,109871330,427030120,615692145,327744,0.0646275283670449,0.060680809077454365,0.1139615194869265,0.07975661897714192,0.27010309278350514,0.2536082474226804,0.4762886597938144
City,Montauk,New York,"New York, NY",1260,1260,1260,3780,141,34,76,251,95735498,34363616,152393668,282492782,834518,0.11190476190476191,0.026984126984126985,0.06031746031746032,0.0664021164021164,0.5617529880478087,0.13545816733067728,0.30278884462151395
City,Mount Pleasant,South Carolina,"Charleston, SC",9960,9958,9959,29877,1097,1877,4267,7241,278139726,834229035,3602325064,4714693825,573764,0.11014056224899599,0.1884916649929705,0.4284566723566623,0.24236034407738394,0.15149841182157162,0.25921834000828614,0.5892832481701422
City,Nassau Bay,Texas,"Houston, TX",479,479,480,1438,10,23,167,200,1805344,5313492,69673238,76792074,314483.5,0.020876826722338204,0.04801670146137787,0.34791666666666665,0.13908205841446453,0.05,0.115,0.835
City,New London,Connecticut,"Norwich, CT",1847,1847,1847,5541,17,17,88,122,2024432,2669361,29061380,33755173,214987,0.009204114780725501,0.009204114780725501,0.047644829453167295,0.0220176863382061,0.13934426229508196,0.13934426229508196,0.7213114754098361
City,Newark,New Jersey,"New York, NY",10433,10433,10434,31300,30,77,313,420,5330655,18810340,112913250,137054245,319694.5,0.0028754912297517493,0.007380427489696156,0.02999808318957255,0.0134185303514377,0.07142857142857142,0.18333333333333332,0.7452380952380953
City,North Port,Florida,"Bradenton, FL",9862,9862,9863,29587,1769,172,48,1989,207733346,30343675,13259431,251336452,126555,0.1793753802474143,0.017440681403366458,0.004866673425935314,0.06722547064589178,0.8893916540975364,0.08647561588738059,0.024132730015082957
City,Ocean City,Maryland,"Salisbury, MD",11271,11271,11272,33814,8145,6586,6745,21476,1215132445,1639006170,3242774826,6096913441,238462.5,0.7226510513707746,0.584331470144619,0.5983853797019163,0.6351215472881055,0.379260569938536,0.3066679083628236,0.31407152169864033
City,Ojus,Florida,"Miami, FL",2446,2438,2443,7327,2083,1858,1665,5606,167028047,285818321,1193503633,1646350001,114568,0.8515944399018807,0.7621000820344545,0.6815390912812116,0.7651153268732087,0.37156617909382805,0.3314306100606493,0.29700321084552267
City,Onancock,Virginia,NA,329,329,329,987,109,61,171,341,13139311,11099507,52287879,76526697,217242,0.331306990881459,0.18541033434650456,0.5197568389057751,0.3454913880445795,0.3196480938416422,0.17888563049853373,0.501466275659824
City,Oxnard,California,"Oxnard, CA",13850,13850,13850,41550,3,16,1039,1058,1183486,8059948,971575507,980818941,844789,2.1660649819494585e-4,0.0011552346570397113,0.07501805054151625,0.0254632972322503,0.002835538752362949,0.015122873345935728,0.9820415879017014
City,Palacios,Texas,"Bay City, TX",880,880,882,2642,26,36,46,108,1696403,3895331,10078171,15669905,118620.5,0.029545454545454545,0.04090909090909091,0.05215419501133787,0.0408781226343679,0.24074074074074073,0.3333333333333333,0.42592592592592593
City,Palm Beach,Florida,"Miami, FL",2854,2852,2850,8556,1378,1281,1609,4268,417909380,1261946075,9645772263,11325627718,998948.5,0.48283111422564823,0.4491584852734923,0.5645614035087719,0.49883122954651704,0.32286785379568883,0.3001405810684161,0.37699156513589505
City,Palm Harbor,Florida,"Tampa, FL",10988,10988,10989,32965,679,777,1254,2710,85782098,181302609,806249033,1073333740,277188.5,0.061794685111030215,0.07071350564251912,0.11411411411411411,0.08220840285150918,0.25055350553505534,0.2867158671586716,0.46273062730627307
City,Patchogue,New York,"New York, NY",3959,3959,3961,11879,156,395,620,1171,41649858,122690800,351087386,515428044,323841,0.03940388987117959,0.09977266986612782,0.1565261297652108,0.09857732132334372,0.1332194705380017,0.3373185311699402,0.5294619982920581
City,Philadelphia,Pennsylvania,"Philadelphia, PA",158916,158911,158913,476740,107,581,1202,1890,9193809,87741841,522869569,619805219,280149.5,6.733116866772383e-4,0.0036561345658890827,0.00756388715838226,0.003964425053488274,0.056613756613756616,0.3074074074074074,0.635978835978836
City,Point Lookout,New York,"New York, NY",265,265,265,795,114,112,83,309,65938040,84363790,92545355,242847185,735462,0.43018867924528303,0.4226415094339623,0.3132075471698113,0.3886792452830189,0.36893203883495146,0.36245954692556637,0.2686084142394822
City,Port Arthur,Texas,"Beaumont, TX",6041,6039,6040,18120,3,35,69,107,165060,2093392,14664230,16922682,115509,4.966065220989903e-4,0.005795661533366451,0.01142384105960265,0.005905077262693157,0.028037383177570093,0.32710280373831774,0.6448598130841121
City,Port Charlotte,Florida,"Port Charlotte, FL",12598,12598,12600,37796,1201,1069,2070,4340,135408508,189163416,857208940,1181780864,209859.5,0.09533259247499604,0.0848547388474361,0.16428571428571428,0.11482696581648852,0.2767281105990783,0.24631336405529955,0.4769585253456221
City,Prairieville,Louisiana,"Baton Rouge, LA",4809,4809,4811,14429,76,80,40,196,12482830,16973976,14218700,43675506,195368,0.015803701393221042,0.016635475150758992,0.008314279775514447,0.01358375493797214,0.3877551020408163,0.40816326530612246,0.20408163265306123
City,Raceland,Louisiana,"Houma, LA",1643,1643,1643,4929,936,752,911,2599,82720086,101457641,200069531,384247258,134165,0.5696895922093731,0.4576993304930006,0.5544735240413877,0.5272874822479204,0.36013851481338977,0.2893420546363986,0.3505194305502116
City,Rockledge,Florida,"Palm Bay, FL",6097,6097,6098,18292,41,74,275,390,6370735,15250804,185799092,207420631,504757.5,0.0067246186649171725,0.012137116614728554,0.04509675303378157,0.021320795976383117,0.10512820512820513,0.18974358974358974,0.7051282051282052
City,Santa Rosa Beach,Florida,"Crestview, FL",4680,4680,4682,14042,855,375,221,1451,173763844,177115962,319986235,670866041,282811,0.18269230769230768,0.08012820512820513,0.047202050405809486,0.10333285856715567,0.5892487939352171,0.2584424534803584,0.15230875258442453
City,Satsuma,Florida,"Palatka, FL",1078,1078,1080,3236,77,238,369,684,2954074,14241794,48410547,65606415,77182.5,0.07142857142857142,0.22077922077922077,0.3416666666666667,0.21137206427688504,0.11257309941520467,0.347953216374269,0.5394736842105263
City,Seabrook Island,South Carolina,"Charleston, SC",769,769,769,2307,681,622,682,1985,184331639,335419726,834008075,1353759440,524568,0.8855656697009102,0.8088426527958388,0.8868660598179454,0.8604247941048981,0.34307304785894205,0.3133501259445844,0.34357682619647356
City,Sealevel,North Carolina,"Morehead City, NC",64,64,64,192,61,64,64,189,4910796,7161243,18565761,30637800,109016,0.953125,1,1,0.984375,0.32275132275132273,0.3386243386243386,0.3386243386243386
City,Sebastian,Florida,"Vero Beach, FL",3711,3711,3711,11133,99,48,172,319,13853104,8674935,79789230,102317269,246699,0.02667744543249798,0.012934518997574777,0.046348693074642955,0.028653552501571904,0.3103448275862069,0.15047021943573669,0.5391849529780565
City,Seminole,Florida,"Tampa, FL",7650,7650,7651,22951,205,209,787,1201,25933192,47671593,388956948,462561733,316556,0.02679738562091503,0.027320261437908496,0.10286237093190433,0.052328874558842754,0.17069109075770192,0.1740216486261449,0.6552872606161532
City,Shallotte,North Carolina,"Conway, SC",1858,1858,1860,5576,8,29,72,109,649440,3826731,24613548,29089719,207042,0.004305705059203444,0.015608180839612486,0.03870967741935484,0.0195480631276901,0.07339449541284404,0.26605504587155965,0.6605504587155964
City,Siesta Key,Florida,"Bradenton, FL",2531,2531,2533,7595,2051,1809,2011,5871,760649324,1092769469,2721561111,4574979904,601492,0.8103516396681154,0.7147372580007902,0.7939202526648244,0.7730085582620145,0.34934423437233864,0.3081246806336229,0.3425310849940385
City,Southampton,New York,"New York, NY",2888,2888,2890,8666,122,273,168,563,98216995,394290288,1110481374,1602988657,1450532,0.04224376731301939,0.09452908587257618,0.05813148788927336,0.06496653588737596,0.216696269982238,0.4849023090586146,0.2984014209591474
City,Southold,New York,"New York, NY",1242,1242,1243,3727,115,156,185,456,54773384,94409581,249087847,398270812,647335,0.09259259259259259,0.12560386473429952,0.14883346741753822,0.12235041588408908,0.25219298245614036,0.34210526315789475,0.4057017543859649
City,Stratford,Connecticut,"Bridgeport, CT",5945,5946,5945,17836,959,123,151,1233,140102023,29919708,62008598,232030329,164005,0.16131202691337257,0.020686175580221997,0.025399495374264086,0.06912984974209464,0.7777777777777778,0.09975669099756691,0.12246553122465531
City,Sullivans Island,South Carolina,"Charleston, SC",318,318,320,956,267,252,228,747,257401367,430588925,673180119,1361170411,1618154,0.839622641509434,0.7924528301886793,0.7125,0.7813807531380753,0.357429718875502,0.3373493975903614,0.30522088353413657
City,Sunset Beach,North Carolina,"Conway, SC",1833,1831,1832,5496,20,40,551,611,2655579,9102800,308606030,320364409,467706,0.010911074740861976,0.02184598580010923,0.300764192139738,0.11117176128093159,0.03273322422258593,0.06546644844517185,0.9018003273322422
City,Tavernier,Florida,"Key West, FL",1038,1038,1039,3115,841,758,931,2530,262387193,384021701,1091251574,1737660468,516946.5,0.8102119460500964,0.7302504816955684,0.8960538979788258,0.812199036918138,0.3324110671936759,0.29960474308300394,0.36798418972332014
City,Union,Washington,"Shelton, WA",465,465,467,1397,8,29,133,170,1288202,8020101,72212172,81520475,432521,0.017204301075268817,0.06236559139784946,0.284796573875803,0.12168933428775948,0.047058823529411764,0.17058823529411765,0.7823529411764706
City,Vineyard Haven,Massachusetts,"Edgartown, MA",1874,1874,1874,5622,77,44,112,233,34069428,30392282,192160133,256621843,752043,0.04108858057630736,0.023479188900747065,0.05976520811099253,0.04144432586268232,0.33047210300429186,0.1888412017167382,0.48068669527896996
City,Wareham,Massachusetts,"Boston, MA",3064,3065,3065,9194,188,203,347,738,35307744,54404073,174184841,263896658,300976,0.06135770234986945,0.06623164763458401,0.11321370309951061,0.08026974113552317,0.25474254742547425,0.2750677506775068,0.470189701897019
City,Warwick,Rhode Island,"Providence, RI",9695,9695,9695,29085,58,49,349,456,9233759,10650010,126118101,146001870,289271,0.005982465188241362,0.005054151624548736,0.03599793708096957,0.015678184631253225,0.12719298245614036,0.1074561403508772,0.7653508771929824
City,West Orange,Texas,"Beaumont, TX",507,507,507,1521,185,125,118,428,8398519,7663248,11275021,27336788,58331,0.36489151873767256,0.2465483234714004,0.23274161735700197,0.28139381985535833,0.43224299065420563,0.29205607476635514,0.2757009345794392
City,Westhampton Beach,New York,"New York, NY",808,808,809,2425,153,361,412,926,98681780,537150070,1512498337,2148330187,1925415.5,0.18935643564356436,0.4467821782178218,0.5092707045735476,0.3818556701030928,0.1652267818574514,0.3898488120950324,0.4449244060475162
City,Weymouth,Massachusetts,"Boston, MA",5590,5590,5592,16772,128,75,93,296,31878822,27947618,49449731,109276171,361718,0.02289803220035778,0.013416815742397137,0.016630901287553648,0.01764846172191748,0.43243243243243246,0.2533783783783784,0.3141891891891892
City,Wildwood Crest,New Jersey,"Upper Township, NJ",1591,1593,1589,4773,913,1153,1005,3071,220095764,432577879,597360317,1250033960,376060,0.573852922690132,0.7237915881983679,0.632473253618628,0.6434108527131783,0.2972972972972973,0.37544773689352,0.3272549658091827
City,Wilmington,Delaware,"Philadelphia, PA",8519,8519,8519,25557,335,44,40,419,29323777,5843708,11822160,46989645,89349,0.039323864303321986,0.005164925460734828,0.004695386782486207,0.016394725515514342,0.7995226730310262,0.10501193317422435,0.0954653937947494
City,Freeport,New York,"New York, NY",3032,3032,3033,9097,1050,1319,1079,3448,323180096,480292658,562733566,1366206320,361979.5,0.34630606860158314,0.4350263852242744,0.3557533794922519,0.379026052544795,0.30452436194895594,0.38254060324825984,0.31293503480278423
City,Kiln,Mississippi,"Gulfport, MS",705,705,706,2116,6,52,103,161,502943,6537786,25237873,32278602,177128,0.00851063829787234,0.07375886524822695,0.14589235127478753,0.07608695652173914,0.037267080745341616,0.32298136645962733,0.639751552795031
City,Leland,North Carolina,"Conway, SC",2429,2429,2431,7289,68,52,9,129,9028854,10879702,3661835,23570391,160176,0.02799505969534788,0.02140798682585426,0.003702180172768408,0.01769790094663191,0.5271317829457365,0.40310077519379844,0.06976744186046512
City,Island Park,New York,"New York, NY",787,787,787,2361,715,706,740,2161,271546030,331863942,527410552,1130820524,472307,0.9085133418043202,0.8970775095298602,0.940279542566709,0.9152901313002965,0.33086534012031465,0.3267006015733457,0.34243405830633966
City,Kapaa,Hawaii,"Kapaa, HI",2246,2246,2246,6738,379,72,58,509,130267130,44059033,59178952,233505115,437654,0.16874443455031166,0.032056990204808546,0.025823686553873553,0.07554170376966458,0.7445972495088409,0.14145383104125736,0.11394891944990176
City,National Park,New Jersey,"Philadelphia, PA",369,369,369,1107,61,46,70,177,7137584,6511888,12572549,26222021,144563,0.16531165311653118,0.12466124661246612,0.1897018970189702,0.15989159891598917,0.3446327683615819,0.2598870056497175,0.3954802259887006
City,Paulina,Louisiana,"New Orleans, LA",322,322,324,968,90,65,121,276,11711959,11686458,31515916,54914333,188268.5,0.2795031055900621,0.20186335403726707,0.3734567901234568,0.28512396694214875,0.32608695652173914,0.23550724637681159,0.4384057971014493
City,Riverside,New Jersey,"Philadelphia, PA",832,832,832,2496,34,64,41,139,4315258,9671749,7610679,21597686,154375,0.040865384615384616,0.07692307692307693,0.04927884615384615,0.05568910256410257,0.2446043165467626,0.460431654676259,0.2949640287769784
City,Point Roberts,Washington,"Bellingham, WA",1114,1114,1115,3343,135,199,129,463,19436805,47833633,90690618,157961056,236301,0.12118491921005387,0.17863554757630162,0.11569506726457399,0.13849835477116362,0.2915766738660907,0.4298056155507559,0.2786177105831533
City,Ocean City,New Jersey,"Upper Township, NJ",4040,4040,4041,12121,3333,3417,2876,9626,1099117220,1872498618,3400780856,6372396694,530627.5,0.825,0.8457920792079208,0.7117050235090324,0.7941588977807111,0.34624974028672345,0.3549761063785581,0.29877415333471846
City,Port Ludlow,Washington,NA,935,935,937,2807,10,37,55,102,2786931,14077588,29983602,46848121,438808.5,0.0106951871657754,0.039572192513368985,0.05869797225186766,0.03633772711079444,0.09803921568627451,0.3627450980392157,0.5392156862745098
City,Stacy,North Carolina,"Morehead City, NC",43,43,44,130,42,42,44,128,3574918,5454864,12406049,21435831,128041,0.9767441860465116,0.9767441860465116,1,0.9846153846153847,0.328125,0.328125,0.34375
City,Sanibel,Florida,"Fort Myers, FL",2397,2397,2399,7193,1858,2043,2174,6075,919656123,1508288984,3206184148,5634129255,759479,0.7751355861493534,0.8523153942428036,0.9062109212171738,0.8445711108021687,0.305843621399177,0.3362962962962963,0.35786008230452676
City,Surf City,North Carolina,"Wilmington, NC",985,985,986,2956,694,781,629,2104,152822889,261316280,334484514,748623683,327934.5,0.7045685279187818,0.7928934010152284,0.6379310344827587,0.7117726657645467,0.32984790874524716,0.37119771863117873,0.29895437262357416
City,Woodlynne,New Jersey,"Philadelphia, PA",292,292,293,877,79,74,34,187,5425619,6077723,3808879,15312221,77374,0.2705479452054795,0.2534246575342466,0.11604095563139932,0.21322690992018245,0.42245989304812837,0.39572192513368987,0.18181818181818182
City,Seabrook,Texas,"Houston, TX",1312,1312,1314,3938,74,60,130,264,9708800,12814399,56979211,79502410,248917,0.056402439024390245,0.04573170731707317,0.0989345509893455,0.0670391061452514,0.2803030303030303,0.22727272727272727,0.49242424242424243
City,Seattle,Washington,"Seattle, WA",63401,63395,63398,190194,459,183,936,1578,187833725,119115408,1927671101,2234620234,992353.5,0.00723963344426744,0.0028866629860399085,0.014763872677371526,0.008296791696898956,0.2908745247148289,0.11596958174904944,0.5931558935361216
City,Tiki Island,Texas,"Houston, TX",320,320,322,962,311,315,319,945,101885836,151450976,240856160,494192972,478245,0.971875,0.984375,0.9906832298136646,0.9823284823284824,0.3291005291005291,0.3333333333333333,0.33756613756613757
City,Shirley,New York,"New York, NY",2553,2553,2553,7659,271,109,235,615,52732285,25716626,237989748,316438659,230949,0.10614962788875833,0.0426948687818253,0.09204857030943987,0.08029768899334117,0.44065040650406506,0.1772357723577236,0.3821138211382114
City,Snow Hill,Maryland,"Salisbury, MD",940,940,940,2820,72,54,117,243,7409983,7996321,37506744,52913048,164475,0.07659574468085106,0.0574468085106383,0.12446808510638298,0.08617021276595745,0.2962962962962963,0.2222222222222222,0.48148148148148145
City,Apollo Beach,Florida,"Tampa, FL",2649,2649,2649,7947,769,211,791,1771,85990699,62727270,421695598,570413567,320271,0.29029822574556435,0.07965269913174783,0.29860324650811626,0.2228513904618095,0.4342179559570864,0.11914172783738002,0.44664031620553357
City,Oceanport,New Jersey,"New York, NY",736,736,737,2209,78,176,293,547,28119195,80664706,297946519,406730420,554643,0.10597826086956522,0.2391304347826087,0.39755766621438265,0.2476233589859665,0.1425959780621572,0.3217550274223035,0.5356489945155393
City,Millsboro,Delaware,"Salisbury, MD",3901,3901,3901,11703,1142,153,199,1494,92256832,25126746,69069994,186453572,86402.5,0.29274544988464496,0.039220712637785184,0.051012560881825174,0.1276595744680851,0.7643908969210174,0.10240963855421686,0.13319946452476572
City,Annapolis,Maryland,"Baltimore, MD",11725,11724,11723,35172,74,223,481,778,21743076,93207566,518718122,633668764,608377,0.006311300639658848,0.019020812009553054,0.041030452955728054,0.022119868076879337,0.09511568123393316,0.2866323907455013,0.6182519280205655
City,Atlantic,North Carolina,"Morehead City, NC",139,139,141,419,42,39,62,143,3670996,4980537,21106936,29758469,144163,0.302158273381295,0.2805755395683453,0.4397163120567376,0.3412887828162291,0.2937062937062937,0.2727272727272727,0.43356643356643354
City,Atlantic Beach,Florida,"Jacksonville, FL",1647,1647,1647,4941,307,265,184,756,55278345,98442310,126692377,280413032,303665,0.18639951426836673,0.16089860352155433,0.11171827565270188,0.15300546448087432,0.4060846560846561,0.3505291005291005,0.24338624338624337
City,Atlantic Beach,North Carolina,"Morehead City, NC",1316,1316,1316,3948,686,549,734,1969,93528205,145336259,400602514,639466978,266669,0.5212765957446809,0.41717325227963525,0.5577507598784195,0.4987335359675785,0.3484002031488065,0.27882173692229556,0.3727780599288979
City,Avon,North Carolina,"Kill Devil Hills, NC",92,92,93,277,92,85,78,255,19714787,29143302,44762523,93620612,325670,1,0.9239130434782609,0.8387096774193549,0.9205776173285198,0.3607843137254902,0.3333333333333333,0.3058823529411765
City,Bay City,Texas,"Bay City, TX",2612,2612,2612,7836,68,79,233,380,6670455,10239499,55904033,72813987,172467,0.026033690658499236,0.03024502297090352,0.08920367534456355,0.04849412965798877,0.17894736842105263,0.20789473684210527,0.6131578947368421
City,Belfair,Washington,"Shelton, WA",1581,1581,1581,4743,31,71,511,613,5094396,19070737,291375535,315540668,459061,0.0196078431372549,0.04490828589500316,0.32321315623023406,0.12924309508749737,0.05057096247960848,0.11582381729200653,0.833605220228385
City,Berlin,Maryland,"Salisbury, MD",5225,5225,5227,15677,1192,1283,2769,5244,178159391,287914144,1232865678,1698939213,272271.5,0.22813397129186602,0.24555023923444977,0.5297493782284293,0.33450277476558016,0.22730739893211288,0.2446605644546148,0.5280320366132724
City,Bluffton,South Carolina,"Bluffton, SC",5066,5066,5066,15198,176,119,426,721,28097225,33388874,347782919,409269018,414374,0.034741413343861036,0.02348993288590604,0.08409001184366365,0.047440452691143574,0.24410540915395285,0.1650485436893204,0.5908460471567267
City,Brick,New Jersey,"New York, NY",9656,9655,9654,28965,374,793,3110,4277,73024010,216569301,1695118721,1984712032,408631,0.03873239436619718,0.08213360952874159,0.3221462606173607,0.14766097013637147,0.08744447042319382,0.18541033434650456,0.7271451952303016
City,Burien,Washington,"Seattle, WA",4562,4562,4562,13686,1,0,220,221,243322,0,261645178,261888500,1117384,2.1920210434020167e-4,0,0.048224462954844366,0.016147888353061524,0.004524886877828055,0,0.995475113122172
City,Camano Island,Washington,"Oak Harbor, WA",2978,2978,2980,8936,132,137,555,824,31379830,53306517,408686348,493372695,557566.5,0.04432505036937542,0.04600402955003358,0.18624161073825504,0.09221128021486123,0.16019417475728157,0.1662621359223301,0.6735436893203883
City,Carol City,Florida,"Miami, FL",1545,1545,1546,4636,523,424,371,1318,102379255,100398211,127210086,329987552,230535.5,0.3385113268608414,0.2744336569579288,0.23997412677878396,0.2842968075927524,0.3968133535660091,0.3216995447647951,0.28148710166919577
City,Church Creek,Maryland,"Cambridge, MD",218,218,220,656,201,187,182,570,21059397,34032552,71670170,126762119,177600.5,0.9220183486238532,0.8577981651376146,0.8272727272727273,0.8689024390243902,0.3526315789473684,0.3280701754385965,0.3192982456140351
City,Cloverdale,Oregon,NA,842,842,844,2528,67,84,26,177,15547384,26233392,11463721,53244497,291546,0.07957244655581948,0.0997624703087886,0.030805687203791468,0.070015822784810125,0.3785310734463277,0.4745762711864407,0.14689265536723164
City,Coronado,California,"San Diego, CA",2208,2208,2209,6625,262,141,610,1013,282845423,229928266,1695384403,2208158092,2051714,0.11865942028985507,0.06385869565217392,0.2761430511543685,0.1529056603773585,0.25863770977295164,0.13919052319842054,0.6021717670286278
City,Cutler Ridge,Florida,"Miami, FL",124,124,126,374,122,69,44,235,11554801,9496789,7340059,28391649,118600,0.9838709677419355,0.5564516129032258,0.3492063492063492,0.6283422459893048,0.5191489361702127,0.2936170212765957,0.18723404255319148
City,Daytona Beach,Florida,"Palm Coast, FL",7009,7009,7009,21027,1948,888,329,3165,118412291,104292093,128595440,351299824,70615,0.2779283777999715,0.12669425024967898,0.04693964902268512,0.15052075902411186,0.6154818325434439,0.28056872037914693,0.10394944707740916
City,Delaware City,Delaware,"Philadelphia, PA",246,246,248,740,117,61,84,262,15476527,10631578,24412490,50520595,167963.5,0.47560975609756095,0.24796747967479674,0.3387096774193548,0.35405405405405405,0.44656488549618323,0.23282442748091603,0.32061068702290074
City,Ewa Beach,Hawaii,"Honolulu, HI",5659,5659,5660,16978,177,121,360,658,80412601,70356801,389004186,539773588,700667,0.03127761088531543,0.02138186958826648,0.0636042402826855,0.03875603722464366,0.2689969604863222,0.1838905775075988,0.547112462006079
City,Fenwick Island,Delaware,"Salisbury, MD",293,293,293,879,120,90,84,294,38983928,49240830,71448830,159673588,530440.5,0.40955631399317405,0.30716723549488056,0.28668941979522183,0.33447098976109213,0.40816326530612246,0.30612244897959184,0.2857142857142857
City,Fernandina Beach,Florida,"Jacksonville, FL",5857,5857,5859,17573,700,507,1035,2242,109587992,169298793,794257678,1073144463,383522,0.11951511012463718,0.08656308690455865,0.17665130568356374,0.12758208615489672,0.31222123104371097,0.22613737734165923,0.4616413916146298
City,Folly Beach,South Carolina,"Charleston, SC",672,672,672,2016,607,465,473,1545,238554241,316842534,563449057,1118845832,632738,0.9032738095238095,0.6919642857142857,0.7038690476190477,0.7663690476190477,0.39288025889967637,0.30097087378640774,0.3061488673139159
City,Fort Myers Beach,Florida,"Fort Myers, FL",3524,3524,3525,10573,3279,2971,2861,9111,851151783,1205327133,2164708287,4221187203,384449,0.9304767309875142,0.8430760499432464,0.8116312056737589,0.8617232573536366,0.35989463286137635,0.32608934255295796,0.3140160245856657
City,Gloucester,Massachusetts,"Boston, MA",3575,3575,3577,10727,96,97,180,373,29711733,41145862,184746411,255604006,478638,0.026853146853146853,0.027132867132867132,0.05032149846239866,0.034772070476368044,0.257372654155496,0.26005361930294907,0.48257372654155495
City,Gonzales,Louisiana,"Baton Rouge, LA",4996,4996,4997,14989,426,223,465,1114,65276718,42655264,128181534,236113516,192581.5,0.08526821457165733,0.044635708566853484,0.09305583350010006,0.07432116885716192,0.38240574506283664,0.2001795332136445,0.41741472172351884
City,Gulf Shores,Alabama,"Fairhope, AL",3266,3266,3267,9799,626,909,1404,2939,92168761,228865141,808257602,1129291504,310210,0.19167176974892836,0.2783221065523576,0.4297520661157025,0.2999285641391979,0.21299761823749574,0.30928887376658726,0.477713507995917
City,Hampton Bays,New York,"New York, NY",2239,2239,2239,6717,35,53,297,385,13132126,26841386,385662783,425636295,952534,0.01563197856185797,0.023671281822242072,0.13264850379633766,0.057317254726812567,0.09090909090909091,0.13766233766233765,0.7714285714285715
City,Hobe Sound,Florida,"Port Saint Lucie, FL",1875,1875,1876,5626,0,3,387,390,0,800533,256447822,257248355,612978,0,0.0016,0.2062899786780384,0.06932100959829364,0,0.007692307692307693,0.9923076923076923
City,Homosassa,Florida,"Inverness, FL",4605,4605,4606,13816,634,628,1291,2553,37078360,79171601,433440280,549690241,174761,0.13767643865363735,0.13637350705754614,0.2802865827181937,0.18478575564562827,0.24833529181355268,0.24598511555033295,0.5056795926361144
City,Honolulu,Hawaii,"Honolulu, HI",40444,40444,40446,121334,14421,10608,4794,29823,4819468073,6666369437,8438222528,19924060038,478401,0.3565671051330234,0.26228859657798437,0.11852840824803441,0.24579260553513443,0.4835529624786239,0.3556986218690273,0.16074841565234885
City,Kitty Hawk,North Carolina,"Kill Devil Hills, NC",364,364,365,1093,115,172,162,449,29126067,52778509,70063270,151967846,318459,0.3159340659340659,0.4725274725274725,0.4438356164383562,0.41079597438243365,0.2561247216035635,0.3830734966592428,0.36080178173719374
City,La Place,Louisiana,"New Orleans, LA",3283,3283,3283,9849,1102,1170,1832,4104,100229133,157132335,360018032,617379500,151727,0.3356685957965276,0.3563813585135547,0.558026195552848,0.4166920499543101,0.26851851851851855,0.2850877192982456,0.44639376218323584
City,Lacey,New Jersey,"New York, NY",3007,3007,3007,9021,307,475,1108,1890,60826193,128119406,536506800,725452399,336450.5,0.10209511140671766,0.15796474891918855,0.36847356168939144,0.20951114067176588,0.16243386243386243,0.25132275132275134,0.5862433862433862
City,Lanexa,Virginia,"Richmond, VA",602,602,604,1808,77,93,86,256,13456955,23656131,35521127,72634213,255478.5,0.12790697674418605,0.15448504983388706,0.1423841059602649,0.1415929203539823,0.30078125,0.36328125,0.3359375
City,Lewes,Delaware,"Salisbury, MD",4256,4256,4258,12770,131,146,357,634,17127274,43828708,204930199,265886181,387266,0.030780075187969925,0.03430451127819549,0.08384217942696101,0.04964761158966327,0.20662460567823343,0.2302839116719243,0.5630914826498423
City,Lilliwaup,Washington,"Shelton, WA",236,236,236,708,9,33,99,141,989100,6202514,43959737,51151351,336954,0.038135593220338986,0.13983050847457626,0.4194915254237288,0.19915254237288135,0.06382978723404255,0.23404255319148937,0.7021276595744681
City,Linwood,New Jersey,"Egg Harbor Township, NJ",871,871,872,2614,64,74,69,207,11906864,18338822,38698348,68944034,246492,0.07347876004592423,0.08495981630309989,0.07912844036697247,0.07918898240244836,0.30917874396135264,0.357487922705314,0.3333333333333333
City,Little Silver,New Jersey,"New York, NY",772,772,774,2318,4,36,172,212,1754295,23069950,260367362,285191607,1209065,0.0051813471502590676,0.046632124352331605,0.2222222222222222,0.091458153580673,0.018867924528301886,0.16981132075471697,0.8113207547169812
City,Lockport,Louisiana,"Houma, LA",763,763,765,2291,556,563,564,1683,49444130,75786383,129424731,254655244,133933,0.72870249017038,0.7378768020969856,0.7372549019607844,0.7346137058053251,0.3303624480095068,0.3345216874628639,0.33511586452762926
City,Manasquan,New Jersey,"New York, NY",968,968,969,2905,383,455,479,1317,178436205,282965576,431283049,892684830,635910,0.3956611570247934,0.4700413223140496,0.49432404540763675,0.4533562822719449,0.29081245254365984,0.3454821564160972,0.36370539104024296
City,Melbourne,Florida,"Palm Bay, FL",9646,9644,9645,28935,104,6,249,359,7758763,1011984,193575812,202346559,417241,0.01078167115902965,6.221484861053505e-4,0.025816485225505444,0.012407119405564196,0.28969359331476324,0.016713091922005572,0.6935933147632312
City,Merritt,North Carolina,"New Bern, NC",103,103,103,309,83,80,96,259,9291302,17745187,40309885,67346374,224808,0.8058252427184466,0.7766990291262136,0.9320388349514563,0.8381877022653722,0.3204633204633205,0.3088803088803089,0.37065637065637064
City,Naples,Florida,"Naples, FL",45209,45209,45210,135628,12262,6524,10058,28844,1899554757,2410120021,16113804367,20423479145,323297.5,0.2712291800305249,0.14430754938176027,0.22247290422472904,0.21266995015778453,0.4251144085425045,0.22618222160587992,0.3487033698516156
City,New Orleans,Louisiana,"New Orleans, LA",32536,32534,32535,97605,46,317,160,523,5278392,70689132,64939910,140907434,248096,0.0014138185394639783,0.009743652794000123,0.0049177808513908095,0.005358332052661237,0.08795411089866156,0.6061185468451242,0.30592734225621415
City,North East,Maryland,"Philadelphia, PA",2401,2401,2403,7205,93,66,105,264,15056425,14354762,64154928,93566115,222181,0.038733860891295296,0.027488546438983758,0.04369538077403246,0.0366412213740458,0.3522727272727273,0.25,0.3977272727272727
City,North Kingstown,Rhode Island,"Providence, RI",3261,3261,3263,9785,8,58,181,247,2197541,21207579,121511597,144916717,497617,0.0024532352039251764,0.01778595522845753,0.05547042598835428,0.02524271844660194,0.032388663967611336,0.23481781376518218,0.7327935222672065
City,Oakland Park,Florida,"Miami, FL",4997,4997,4999,14993,3773,2146,3489,9408,388428935,400627687,1240627965,2029684587,186994.5,0.7550530318190914,0.42945767460476286,0.6979395879175835,0.6274928299873275,0.4010416666666667,0.22810374149659865,0.3708545918367347
City,Orange,Texas,"Beaumont, TX",2116,2116,2117,6349,374,238,110,722,17122216,16398344,12945823,46466383,56861.5,0.1767485822306238,0.11247637051039698,0.051960321209258385,0.11371869585761538,0.518005540166205,0.3296398891966759,0.1523545706371191
City,Pembroke Pines,Florida,"Miami, FL",18902,18903,18901,56706,13904,9606,3899,27409,1817797911,2635113271,1557545862,6010457044,219396,0.7355835361337425,0.5081733058244723,0.2062853817258346,0.48335273163333686,0.5072786311065708,0.35046882410886937,0.14225254478455981
City,Ponte Vedra Beach,Florida,"Jacksonville, FL",4618,4618,4619,13855,1315,2655,2531,6501,309438620,1340716684,2748710272,4398865576,566030,0.2847553053269814,0.5749242096145517,0.5479541026196146,0.4692168892096716,0.20227657283494846,0.40839870789109367,0.38932471927395784
City,Port Richey,Florida,"Tampa, FL",6329,6329,6329,18987,677,127,956,1760,28738542,11592551,253106283,293437376,122102.5,0.10696792542265761,0.0200663611945015,0.15105071891294045,0.09269500184336651,0.3846590909090909,0.07215909090909091,0.5431818181818182
City,Port Saint Joe,Florida,"Panama City, FL",1738,1738,1740,5216,232,271,499,1002,30514595,64093909,281028862,375637366,316272.5,0.1334867663981588,0.15592635212888378,0.2867816091954023,0.19210122699386503,0.2315369261477046,0.27045908183632733,0.49800399201596807
City,Redington Shores,Florida,"Tampa, FL",638,636,637,1911,500,500,569,1569,162911937,236477552,417052072,816441561,484751,0.7836990595611285,0.7861635220125787,0.8932496075353218,0.8210361067503925,0.3186743148502231,0.3186743148502231,0.36265137029955385
City,Salisbury,Maryland,"Salisbury, MD",7986,7986,7986,23958,36,52,194,282,3324467,7219503,64695400,75239370,211354,0.004507888805409466,0.006511394941147007,0.02429251189581768,0.011770598547458051,0.1276595744680851,0.18439716312056736,0.6879432624113475
City,Sarasota,Florida,"Bradenton, FL",34473,34473,34473,103419,314,839,3630,4783,39614066,234011711,4722961708,4996587485,579881,0.009108577727496882,0.02433788762219708,0.10529979984335568,0.046248755064349875,0.06564917415847794,0.17541292076102866,0.7589379050804934
City,Satellite Beach,Florida,"Palm Bay, FL",2511,2511,2513,7535,910,679,1163,2752,196183465,211679170,701802856,1109665491,331901,0.362405416168857,0.27041019514137793,0.4627934739355352,0.3652289316522893,0.33066860465116277,0.2467296511627907,0.4226017441860465
City,Saugus,Massachusetts,"Boston, MA",2862,2862,2864,8588,208,182,199,589,68957421,73505103,103773654,246236178,398769,0.0726764500349406,0.06359189378057302,0.0694832402234637,0.06858407079646017,0.3531409168081494,0.3089983022071307,0.3378607809847199
City,Sayreville,New Jersey,"New York, NY",1786,1786,1787,5359,29,88,16,133,6918790,26713260,5840491,39472541,297653,0.016237402015677492,0.04927211646136618,0.008953553441522105,0.024818063071468558,0.21804511278195488,0.6616541353383458,0.12030075187969924
City,Sea Bright,New Jersey,"New York, NY",333,333,333,999,219,280,261,760,56830837,130387246,295843173,483061256,444238,0.6576576576576577,0.8408408408408409,0.7837837837837838,0.7607607607607607,0.2881578947368421,0.3684210526315789,0.34342105263157896
City,Seabrook,New Hampshire,"Boston, MA",1377,1377,1378,4132,89,62,458,609,11428657,17513989,292443289,321385935,546836,0.06463326071169208,0.045025417574437183,0.33236574746008707,0.1473862536302033,0.14614121510673234,0.10180623973727422,0.7520525451559934
City,Seaside,Oregon,"Astoria, OR",963,963,964,2890,93,54,17,164,19608292,15083956,7610255,42302503,238925.5,0.09657320872274143,0.056074766355140186,0.017634854771784232,0.05674740484429066,0.5670731707317073,0.32926829268292684,0.10365853658536585
City,Shawboro,North Carolina,"Virginia Beach, VA",131,131,131,393,56,53,37,146,8133638,11434679,12052639,31620956,205026.5,0.42748091603053434,0.40458015267175573,0.2824427480916031,0.37150127226463103,0.3835616438356164,0.363013698630137,0.2534246575342466
City,Sorrento,Louisiana,"Baton Rouge, LA",485,485,487,1457,458,184,68,710,70150646,35093731,19160883,124405260,163957.5,0.9443298969072165,0.37938144329896906,0.13963039014373715,0.48730267673301303,0.6450704225352113,0.2591549295774648,0.09577464788732394
City,Strathmere,New Jersey,"Upper Township, NJ",123,123,125,371,123,122,112,357,66930604,105881453,144091661,316903718,868892,1,0.991869918699187,0.896,0.9622641509433962,0.3445378151260504,0.34173669467787116,0.3137254901960784
City,Sunset,Florida,"Miami, FL",1691,1691,1691,5073,202,184,143,529,61872606,67739497,81438283,211050386,361386,0.11945594322885866,0.10881135422826729,0.08456534594914251,0.10427754780208949,0.3818525519848771,0.34782608695652173,0.27032136105860116
City,Surf City,New Jersey,"New York, NY",728,728,728,2184,692,716,507,1915,353063019,483377901,587454150,1423895070,619687,0.9505494505494505,0.9835164835164835,0.6964285714285714,0.8768315018315018,0.36135770234986947,0.37389033942558747,0.26475195822454306
City,Truro,Massachusetts,"East Falmouth, MA",806,806,808,2420,111,25,40,176,37265522,17272703,52228985,106767210,425763,0.13771712158808933,0.031017369727047148,0.04950495049504951,0.07272727272727272,0.6306818181818182,0.14204545454545456,0.22727272727272727
City,Venice,Florida,"Bradenton, FL",13442,13442,13444,40328,345,277,696,1318,42926039,71580505,465269407,579775951,323318,0.025665823538163962,0.02060705252194614,0.051770306456411785,0.03268200753818687,0.26176024279210924,0.2101669195751138,0.5280728376327769
City,Waldport,Oregon,"Lincoln City, OR",1098,1098,1098,3294,163,36,53,252,27227960,8448171,20061747,55737878,175087.5,0.14845173041894352,0.03278688524590164,0.0482695810564663,0.07650273224043716,0.6468253968253969,0.14285714285714285,0.21031746031746032
City,Westover,Maryland,"Salisbury, MD",551,551,551,1653,326,266,260,852,23127720,28209994,60112115,111449829,97947.5,0.5916515426497277,0.4827586206896552,0.47186932849364793,0.515426497277677,0.3826291079812207,0.31220657276995306,0.3051643192488263
City,Wilmington,North Carolina,"Wilmington, NC",21352,21352,21354,64058,177,404,1248,1829,23283179,86682949,1294245518,1404211646,381520,0.008289621581116523,0.018920944173847883,0.05844338297274515,0.028552249523868995,0.0967741935483871,0.22088572990705305,0.6823400765445599
City,Yulee,Florida,"Jacksonville, FL",2077,2077,2079,6233,114,73,194,381,11258713,13417879,55947640,80624232,208829,0.0548868560423688,0.03514684641309581,0.09331409331409331,0.06112626343654741,0.2992125984251969,0.19160104986876642,0.5091863517060368
City,Big Pine Key,Florida,"Key West, FL",869,869,871,2609,853,867,863,2583,248649332,369175390,646537160,1264361882,420292,0.9815880322209436,0.997698504027618,0.9908151549942594,0.9900344959754696,0.3302361595044522,0.3356562137049942,0.3341076267905536
City,Blue Point,New York,"New York, NY",535,533,535,1603,57,143,162,362,19358694,55763624,112376173,187498491,416121,0.10654205607476636,0.2682926829268293,0.30280373831775703,0.22582657517155333,0.1574585635359116,0.39502762430939226,0.44751381215469616
City,Bozman,Maryland,"Easton, MD",154,154,155,463,53,71,64,188,14397555,34059884,81867253,130324692,457899,0.34415584415584416,0.461038961038961,0.4129032258064516,0.4060475161987041,0.28191489361702127,0.3776595744680851,0.3404255319148936
City,Crescent Beach,Florida,"Jacksonville, FL",539,473,507,1519,313,259,224,796,69821415,84195736,155973265,309990416,308453,0.5807050092764379,0.547568710359408,0.4418145956607495,0.5240289664252797,0.39321608040201006,0.32537688442211055,0.2814070351758794
City,Croydon,Pennsylvania,"Philadelphia, PA",1065,1065,1065,3195,47,29,56,132,6499989,5222605,12963572,24686166,185155,0.044131455399061034,0.027230046948356807,0.05258215962441314,0.04131455399061033,0.3560606060606061,0.2196969696969697,0.42424242424242425
City,Avon by the Sea,New Jersey,"New York, NY",336,336,337,1009,0,45,67,112,0,38547298,102071583,140618881,1158064,0,0.13392857142857142,0.19881305637982197,0.1110009910802775,0,0.4017857142857143,0.5982142857142857
City,Bald Head Island,North Carolina,"Conway, SC",273,273,273,819,121,153,161,435,64427960,114963137,242324030,421715127,776568,0.4432234432234432,0.5604395604395604,0.5897435897435898,0.5311355311355311,0.27816091954022987,0.35172413793103446,0.3701149425287356
City,Goulds,Florida,"Miami, FL",817,817,817,2451,63,53,7,123,8185403,11790828,2098658,22074889,192250,0.07711138310893513,0.06487148102815178,0.008567931456548347,0.05018359853121175,0.5121951219512195,0.43089430894308944,0.056910569105691054
City,Hanahan,South Carolina,"Charleston, SC",1747,1747,1748,5242,61,140,84,285,9623283,28561225,31778273,69962781,205345,0.034917000572409845,0.08013737836290784,0.04805491990846682,0.05436856161770317,0.21403508771929824,0.49122807017543857,0.29473684210526313
City,Nags Head,North Carolina,"Kill Devil Hills, NC",265,265,266,796,37,92,94,223,9258225,29235412,45346762,83840399,346760,0.13962264150943396,0.3471698113207547,0.3533834586466165,0.28015075376884424,0.16591928251121077,0.4125560538116592,0.42152466367713004
City,Nahant,Massachusetts,"Boston, MA",465,465,466,1396,54,72,58,184,21553028,40494371,49578520,111625919,563795.5,0.11612903225806452,0.15483870967741936,0.12446351931330472,0.1318051575931232,0.29347826086956524,0.391304347826087,0.31521739130434784
City,Marshallberg,North Carolina,"Morehead City, NC",109,109,109,327,105,100,103,308,11336282,16169985,34712904,62219171,158997,0.963302752293578,0.9174311926605505,0.944954128440367,0.9418960244648318,0.3409090909090909,0.3246753246753247,0.3344155844155844
City,Penns Grove,New Jersey,"Philadelphia, PA",420,420,420,1260,64,95,184,343,4575151,8470506,25359975,38405632,102577,0.1523809523809524,0.2261904761904762,0.4380952380952381,0.2722222222222222,0.18658892128279883,0.27696793002915454,0.5364431486880467
City,Ocean Park,Maine,"Portland, ME",37,37,38,112,36,36,29,101,9245120,12817780,14693929,36756829,353623,0.972972972972973,0.972972972972973,0.7631578947368421,0.9017857142857143,0.3564356435643564,0.3564356435643564,0.2871287128712871
City,Ocean Ridge,Florida,"Miami, FL",421,421,422,1264,225,206,238,669,58607840,174684392,485654713,718946945,840576,0.5344418052256532,0.48931116389548696,0.5639810426540285,0.5292721518987342,0.336322869955157,0.30792227204783257,0.35575485799701045
City,Poulsbo,Washington,"Bremerton, WA",3616,3616,3618,10850,7,12,111,130,1832314,4945332,90586297,97363943,726063,0.0019358407079646017,0.00331858407079646,0.03067993366500829,0.011981566820276499,0.05384615384615385,0.09230769230769231,0.8538461538461538
City,Sunny Isles Beach,Florida,"Miami, FL",5528,5499,5514,16541,5148,4384,1916,11448,1151741298,1937348147,3433420115,6522509560,325183,0.9312590448625181,0.7972358610656483,0.3474791439970983,0.692098422102654,0.449685534591195,0.3829489867225716,0.16736547868623342
City,Ventnor City,New Jersey,"Egg Harbor Township, NJ",1994,1994,1996,5984,1622,1777,874,4273,272913759,466544982,433394006,1172852747,239144,0.8134403209628887,0.8911735205616851,0.437875751503006,0.7140708556149733,0.37959279194945006,0.4158670723145331,0.20454013573601684
City,Waipahu,Hawaii,"Honolulu, HI",5473,5473,5473,16419,265,73,53,391,69028152,45461344,42621048,157110544,219467,0.04841951397770875,0.013338205737255618,0.00968390279554175,0.023813874170168708,0.6777493606138107,0.1867007672634271,0.13554987212276215
City,Shalimar,Florida,"Crestview, FL",1362,1362,1363,4087,161,59,146,366,16225689,15411679,85757656,117395024,259922,0.11820851688693099,0.04331864904552129,0.10711665443873808,0.08955223880597014,0.43989071038251365,0.16120218579234974,0.3989071038251366
City,Sneads Ferry,North Carolina,"Jacksonville, NC",399,399,399,1197,38,43,141,222,3666708,6832329,40212532,50711569,206911,0.09523809523809523,0.10776942355889724,0.3533834586466165,0.18546365914786966,0.17117117117117117,0.19369369369369369,0.6351351351351351
City,Saint Amant,Louisiana,"Baton Rouge, LA",1171,1171,1171,3513,709,782,770,2261,108930470,149259144,222153660,480343274,190060,0.605465414175918,0.667805294619983,0.6575576430401366,0.6436094506120126,0.31357806280406897,0.3458646616541353,0.34055727554179566
City,Carrabelle,Florida,NA,671,671,672,2014,35,104,184,323,4246072,16208849,69385451,89840372,238756,0.05216095380029806,0.15499254843517138,0.27380952380952384,0.16037735849056603,0.10835913312693499,0.3219814241486068,0.5696594427244582
City,Ellenton,Florida,"Bradenton, FL",1281,1281,1282,3844,14,201,293,508,1266844,36691784,124150791,162109419,265436,0.01092896174863388,0.15690866510538642,0.22854914196567863,0.13215400624349635,0.027559055118110236,0.3956692913385827,0.5767716535433071
City,Groton Long Point,Connecticut,"Norwich, CT",207,207,208,622,105,105,129,339,54164192,76387294,168420936,298972422,772476,0.5072463768115942,0.5072463768115942,0.6201923076923077,0.545016077170418,0.30973451327433627,0.30973451327433627,0.3805309734513274
City,Wilmington Island,Georgia,"Savannah, GA",1855,1855,1856,5566,374,444,676,1494,75555888,115616517,328600476,519772881,286532,0.20161725067385444,0.2393530997304582,0.3642241379310345,0.26841537908731583,0.250334672021419,0.2971887550200803,0.4524765729585007
City,Terra Ceia,Florida,"Bradenton, FL",80,80,81,241,74,63,59,196,16579517,27277273,51205191,95061981,425802.5,0.925,0.7875,0.7283950617283951,0.8132780082987552,0.37755102040816324,0.32142857142857145,0.3010204081632653
City,Abbeville,Louisiana,"Lafayette, LA",1995,1995,1997,5987,196,512,191,899,15221011,53996645,30967445,100185101,103417,0.09824561403508772,0.25664160401002506,0.09564346519779669,0.1501586771337899,0.21802002224694106,0.5695216907675195,0.21245828698553948
City,Amityville,New York,"New York, NY",2254,2254,2255,6763,72,532,1125,1729,18503506,182721742,570274108,771499356,416548,0.03194321206743567,0.2360248447204969,0.49889135254988914,0.25565577406476414,0.041642567958357433,0.3076923076923077,0.6506651243493349
City,Bainbridge Island,Washington,"Bremerton, WA",2991,2991,2991,8973,71,95,583,749,38729919,75949313,977417390,1092096622,1315816,0.023737880307589436,0.031761952524239384,0.1949180875961217,0.08347264014265017,0.09479305740987984,0.1268357810413885,0.7783711615487316
City,Bay Head,New Jersey,"New York, NY",315,315,317,947,258,300,188,746,211139645,384282007,458847956,1054269608,1198036.5,0.819047619047619,0.9523809523809523,0.5930599369085173,0.7877507919746568,0.34584450402144773,0.40214477211796246,0.2520107238605898
City,Berkeley,New Jersey,"New York, NY",7710,7708,7711,23129,47,261,2880,3188,6408992,51356643,1301899150,1359664785,373919,0.0060959792477302205,0.033860923715620134,0.3734924134353521,0.13783561762289767,0.014742785445420327,0.08186951066499373,0.903387703889586
City,Bokeelia,Florida,"Fort Myers, FL",829,829,831,2489,464,555,583,1602,61051027,136809591,348215710,546076328,251118,0.5597104945717732,0.669481302774427,0.7015643802647413,0.6436319807151466,0.28963795255930086,0.3464419475655431,0.36392009987515606
City,Briny Breezes,Florida,"Miami, FL",164,164,165,493,94,30,99,223,13906855,4921581,26205717,45034153,164109,0.573170731707317,0.18292682926829268,0.6,0.45233265720081134,0.42152466367713004,0.13452914798206278,0.4439461883408072
City,Cape May Court House,New Jersey,"Upper Township, NJ",802,802,804,2408,32,36,80,148,6220673,8711028,40517823,55449524,284777,0.0399002493765586,0.04488778054862843,0.09950248756218906,0.061461794019933555,0.21621621621621623,0.24324324324324326,0.5405405405405406
City,Carrollton,Virginia,"Virginia Beach, VA",1035,1035,1035,3105,10,30,78,118,1805188,7636229,34711378,44152795,352900.5,0.00966183574879227,0.028985507246376812,0.07536231884057971,0.038003220611916265,0.0847457627118644,0.2542372881355932,0.6610169491525424
City,Chauvin,Louisiana,"Houma, LA",660,660,660,1980,627,613,623,1863,60474989,71642116,91620798,223737903,116594,0.95,0.9287878787878788,0.943939393939394,0.9409090909090909,0.3365539452495974,0.3290391841116479,0.3344068706387547
City,Churchton,Maryland,"Baltimore, MD",442,442,442,1326,96,94,170,360,24957023,30023516,92615845,147596384,343295,0.2171945701357466,0.21266968325791855,0.38461538461538464,0.27149321266968324,0.26666666666666666,0.2611111111111111,0.4722222222222222
City,Cinnaminson,New Jersey,"Philadelphia, PA",1906,1906,1907,5719,239,28,10,277,42131116,7037214,3749801,52918131,184487,0.12539349422875132,0.014690451206715634,0.005243838489774515,0.04843504109109984,0.8628158844765343,0.10108303249097472,0.036101083032490974
City,Clatskanie,Oregon,"Portland, OR",681,681,682,2044,39,46,32,117,6957135,10222680,14087315,31267130,212794,0.05726872246696035,0.06754772393538913,0.0469208211143695,0.05724070450097847,0.3333333333333333,0.39316239316239315,0.27350427350427353
City,Clear Lake Shores,Texas,"Houston, TX",226,226,228,680,85,130,131,346,12623428,32779587,69213887,114616902,279343,0.37610619469026546,0.5752212389380531,0.5745614035087719,0.5088235294117647,0.24566473988439305,0.37572254335260113,0.3786127167630058
City,Coden,Alabama,"Mobile, AL",538,538,540,1616,271,289,173,733,13318362,20525558,38880847,72724767,64205,0.5037174721189591,0.5371747211895911,0.32037037037037036,0.4535891089108911,0.36971350613915416,0.3942701227830832,0.23601637107776263
City,Copiague,New York,"New York, NY",1535,1535,1535,4605,43,47,759,849,10630461,13494228,315557898,339682587,357931,0.028013029315960912,0.03061889250814332,0.4944625407166124,0.18436482084690553,0.050647820965842166,0.05535924617196702,0.8939929328621908
City,Coral Gables,Florida,"Miami, FL",5531,5531,5532,16594,647,62,495,1204,196564491,55375305,1871915025,2123854821,445787.5,0.11697703851021515,0.011209546194178268,0.08947939262472886,0.0725563456671086,0.5373754152823921,0.05149501661129568,0.4111295681063123
City,Currituck,North Carolina,"Virginia Beach, VA",187,187,189,563,97,123,119,339,19852376,33287719,45981988,99122083,274647,0.5187165775401069,0.6577540106951871,0.6296296296296297,0.6021314387211367,0.2861356932153392,0.36283185840707965,0.35103244837758113
City,Deal Island,Maryland,"Salisbury, MD",419,419,421,1259,363,352,307,1022,30491403,42496357,72058218,145045978,115470,0.8663484486873508,0.8400954653937948,0.7292161520190024,0.8117553613979349,0.35518590998043054,0.34442270058708413,0.30039138943248533
City,Des Moines,Washington,"Seattle, WA",2960,2960,2962,8882,44,6,61,111,8217455,2159190,43505028,53881673,403360,0.014864864864864866,0.002027027027027027,0.020594193112761647,0.012497185318621932,0.3963963963963964,0.05405405405405406,0.5495495495495496
City,Dunnsville,Virginia,NA,404,404,406,1214,2,31,100,133,261398,5260798,37242989,42765185,317784,0.0049504950495049506,0.07673267326732673,0.24630541871921183,0.10955518945634267,0.015037593984962405,0.23308270676691728,0.7518796992481203
City,Eagleswood Township,New Jersey,"New York, NY",236,236,236,708,81,53,50,184,13259140,12066116,19040320,44365576,211251,0.3432203389830508,0.2245762711864407,0.211864406779661,0.2598870056497175,0.44021739130434784,0.28804347826086957,0.2717391304347826
City,East Quogue,New York,"New York, NY",916,916,918,2750,73,67,238,378,32752373,43573726,383533577,459859676,930837.5,0.07969432314410481,0.07314410480349345,0.25925925925925924,0.13745454545454547,0.1931216931216931,0.17724867724867724,0.6296296296296297
City,Emerald Isle,North Carolina,"Morehead City, NC",1947,1947,1949,5843,43,176,215,434,11194353,68119491,149386787,228700631,461060,0.022085259373394967,0.0903954802259887,0.11031298101590559,0.07427691254492555,0.09907834101382489,0.4055299539170507,0.49539170506912444
City,Ewell,Maryland,"Salisbury, MD",77,77,79,233,77,77,79,233,6271562,6915518,11297425,24484505,88549,1,1,1,1,0.33047210300429186,0.33047210300429186,0.33905579399141633
City,Florida City,Florida,"Miami, FL",692,692,693,2077,226,199,180,605,23903757,29556815,41791340,95251912,146075,0.3265895953757225,0.2875722543352601,0.2597402597402597,0.2912855079441502,0.37355371900826445,0.32892561983471075,0.2975206611570248
City,Foley,Alabama,"Fairhope, AL",3055,3055,3057,9167,31,47,230,308,3541438,7330901,92302140,103174479,307904.5,0.010147299509001636,0.015384615384615385,0.07523716061498201,0.033598778226246316,0.10064935064935066,0.1525974025974026,0.7467532467532467
City,Greenbank,Washington,"Oak Harbor, WA",556,556,557,1669,54,66,176,296,13292816,27392217,127189529,167874562,543285,0.09712230215827339,0.11870503597122302,0.31597845601436264,0.1773517076093469,0.18243243243243243,0.22297297297297297,0.5945945945945946
City,Gulfport,Florida,"Tampa, FL",2180,2180,2180,6540,788,600,1026,2414,89993273,104669165,511922190,706584628,181767,0.3614678899082569,0.27522935779816515,0.4706422018348624,0.3691131498470948,0.3264291632145816,0.24855012427506215,0.4250207125103563
City,Havelock,North Carolina,"New Bern, NC",2036,2034,2035,6105,42,36,199,277,3692820,4536227,52271955,60501002,180476,0.0206286836935167,0.017699115044247787,0.0977886977886978,0.045372645372645376,0.15162454873646208,0.1299638989169675,0.7184115523465704
City,Hialeah,Florida,"Miami, FL",17215,17215,17215,51645,11394,7189,5195,23778,1531081831,1639411187,1690627473,4861120491,166583.5,0.661864652918966,0.4176009294220157,0.3017717107173976,0.4604124310194598,0.47918243754731266,0.3023382959037766,0.21847926654891076
City,Hoboken,New Jersey,"New York, NY",4241,4241,4241,12723,3035,3131,2069,8235,1505857937,2353807234,2599276142,6458941313,725903,0.7156331053996698,0.7382692761141241,0.48785663758547515,0.647253006366423,0.36854887674559805,0.3802064359441409,0.25124468731026106
City,Houma,Louisiana,"Houma, LA",7709,7709,7711,23129,4855,4928,5530,15313,465697010,732178884,1518263106,2716139e3,153143,0.6297833700869114,0.6392528213776106,0.7171573077421864,0.6620692636949285,0.31705087180826746,0.3218180630836544,0.36113106510807813
City,Hudson,Florida,"Tampa, FL",7134,7134,7134,21402,764,1162,1660,3586,52446846,155197223,410792783,618436852,159837,0.1070927950658817,0.16288197364732268,0.23268853378188956,0.1675544341650313,0.21305075292805353,0.32403792526491915,0.4629113218070273
City,Huntington Beach,California,"Los Angeles, CA",19084,19084,19084,57252,5308,10479,7771,23558,2738264876,8179433494,9081438791,19999137161,803880,0.278138754977992,0.5490987214420457,0.4071997484804024,0.4114790749668134,0.22531624076746753,0.4448170472875456,0.32986671194498685
City,Indian Beach,North Carolina,"Morehead City, NC",318,318,318,954,96,100,61,257,19541280,30045178,44306381,93892839,286808,0.3018867924528302,0.31446540880503143,0.1918238993710692,0.2693920335429769,0.3735408560311284,0.38910505836575876,0.23735408560311283
City,Indian Shores,Florida,"Tampa, FL",819,819,821,2459,649,630,476,1755,183633320,253819601,373734031,811186952,379384,0.7924297924297924,0.7692307692307693,0.5797807551766139,0.7137047580317202,0.3698005698005698,0.358974358974359,0.2712250712250712
City,Jacksonville,Florida,"Jacksonville, FL",91099,91097,91098,273294,2041,2159,7239,11439,171827065,333870612,3184815434,3690513111,242618,0.02240419763114853,0.02370001207504089,0.0794638740696832,0.04185602318382401,0.17842468747268117,0.1887402744995192,0.6328350380277996
City,Jersey City,New Jersey,"New York, NY",13763,13763,13763,41289,24,366,3819,4209,6064856,145571431,3285880350,3437516637,740026,0.001743805856281334,0.026593039308290344,0.27748310688076727,0.10193998401511298,0.005702066999287242,0.08695652173913043,0.9073414112615823
City,Jupiter,Florida,"Miami, FL",10090,10088,10089,30267,859,1408,695,2962,202084125,484068872,899587843,1585740840,332492,0.08513379583746283,0.13957176843774782,0.0688869065318664,0.0978623583440711,0.2900067521944632,0.475354490209318,0.23463875759621877
City,Kaunakakai,Hawaii,"Wailuku, HI",735,735,735,2205,308,223,213,744,71215118,79889335,125237384,276341837,326368.5,0.41904761904761906,0.3034013605442177,0.2897959183673469,0.33741496598639453,0.41397849462365593,0.29973118279569894,0.2862903225806452
City,Kendall,Florida,"Miami, FL",9217,9217,9219,27653,1332,786,305,2423,233831292,232177283,158220241,624228816,215397,0.14451556905717697,0.08527720516437018,0.033083848573598,0.08762159621017611,0.5497317375154767,0.3243912505158894,0.12587701196863393
City,Lake Worth,Florida,"Miami, FL",3798,3798,3800,11396,296,184,727,1207,31019867,30830738,444541544,506392149,287516,0.07793575566087414,0.04844655081621906,0.19131578947368422,0.10591435591435591,0.2452361226180613,0.15244407622203812,0.6023198011599006
City,Lancaster,Virginia,NA,640,640,641,1921,39,54,77,170,4903287,11821794,34912016,51637097,250584.5,0.0609375,0.084375,0.12012480499219969,0.08849557522123894,0.22941176470588234,0.3176470588235294,0.45294117647058824
City,Leipsic,Delaware,"Dover, DE",46,46,46,138,35,32,34,101,3651411,4337518,8079905,16068834,130868,0.7608695652173914,0.6956521739130435,0.7391304347826086,0.7318840579710145,0.3465346534653465,0.31683168316831684,0.33663366336633666
City,Leonardtown,Maryland,"Mechanicsville, MD",1829,1829,1829,5487,90,121,55,266,21501908,38402518,28806282,88710708,300248.5,0.049207217058501916,0.0661563696008748,0.030071077091306724,0.04847822125022781,0.3383458646616541,0.4548872180451128,0.20676691729323307
City,Long Branch,New Jersey,"New York, NY",2539,2539,2540,7618,261,264,217,742,65196417,96019363,151199079,312414859,348232,0.10279637652619142,0.10397794407246948,0.08543307086614173,0.09740089262273563,0.35175202156334234,0.3557951482479784,0.29245283018867924
City,Longboat Key,Florida,"Bradenton, FL",2857,2853,2855,8565,1841,1694,1378,4913,651447622,1138190633,2333692326,4123330581,614703,0.6443822191109555,0.5937609533824045,0.482661996497373,0.5736135434909515,0.37472013026663953,0.3447995115001018,0.2804803582332587
City,Matagorda,Texas,"Bay City, TX",114,114,115,343,59,70,84,213,7195974,11814367,24165636,43175977,177467,0.5175438596491229,0.6140350877192983,0.7304347826086957,0.6209912536443148,0.27699530516431925,0.3286384976525822,0.39436619718309857
City,Mattituck,New York,"New York, NY",788,788,790,2366,51,77,57,185,23075075,43943358,61834497,128852930,565239,0.06472081218274112,0.09771573604060914,0.07215189873417721,0.07819103972950127,0.2756756756756757,0.41621621621621624,0.3081081081081081
City,Middle River,Maryland,"Baltimore, MD",4114,4115,4114,12343,50,198,1141,1389,7751575,42139344,501113797,551004716,357958,0.012153621779290228,0.048116646415552855,0.277345649003403,0.11253341975208621,0.03599712023038157,0.14254859611231102,0.8214542836573074
City,Milton,Delaware,"Salisbury, MD",1899,1899,1901,5699,46,53,77,176,8133865,12897817,36409812,57441494,260539,0.02422327540810953,0.027909426013691417,0.04050499736980537,0.030882610984383226,0.26136363636363635,0.30113636363636365,0.4375
City,Moyock,North Carolina,"Virginia Beach, VA",1115,1115,1116,3346,430,275,401,1106,80176772,73433239,148395624,302005635,259563,0.38565022421524664,0.24663677130044842,0.3593189964157706,0.3305439330543933,0.3887884267631103,0.24864376130198915,0.36256781193490056
City,Nehalem,Oregon,NA,955,955,957,2867,127,17,1,145,26457046,5556406,471794,32485246,212916,0.13298429319371727,0.01780104712041885,0.0010449320794148381,0.05057551447506104,0.8758620689655172,0.11724137931034483,0.006896551724137931
City,Neptune,New Jersey,"New York, NY",3744,3744,3744,11232,8,140,116,264,1895716,40005586,48136448,90037750,320964,0.002136752136752137,0.03739316239316239,0.030982905982905984,0.023504273504273504,0.030303030303030304,0.5303030303030303,0.4393939393939394
City,New Bern,North Carolina,"New Bern, NC",4860,4860,4862,14582,581,292,402,1275,40737308,34663627,119252827,194653762,109598,0.11954732510288066,0.060082304526748974,0.08268202385849445,0.0874365656288575,0.4556862745098039,0.22901960784313727,0.31529411764705884
City,New Castle,Delaware,"Philadelphia, PA",6007,6007,6007,18021,69,147,130,346,8678442,26968344,38404437,74051223,189844,0.011486598967870817,0.024471449975029133,0.021641418345263858,0.019199822429387937,0.1994219653179191,0.42485549132947975,0.37572254335260113
City,New Iberia,Louisiana,"Lafayette, LA",5456,5454,5457,16367,476,325,148,949,33643862,33167294,25497867,92309023,78153,0.0872434017595308,0.05958929226255959,0.02712112882536192,0.05798252581413821,0.5015806111696522,0.3424657534246575,0.1559536354056902
City,Newport,Rhode Island,"Providence, RI",2638,2638,2638,7914,104,198,173,475,33486760,92131420,235663506,361281686,488108,0.039423805913570885,0.07505686125852919,0.06557998483699773,0.060020217336365936,0.21894736842105264,0.4168421052631579,0.3642105263157895
City,Newport News,Virginia,"Virginia Beach, VA",15601,15599,15601,46801,371,58,247,676,39438031,10204402,123929809,173572242,134816,0.02378052688930197,0.0037181870632732868,0.015832318441125568,0.014444135809063908,0.5488165680473372,0.08579881656804733,0.36538461538461536
City,North Myrtle Beach,South Carolina,"Conway, SC",6399,6395,6397,19191,631,914,1963,3508,78807709,209323566,862636792,1150768067,285247,0.09860915768088764,0.14292415949960907,0.306862591839925,0.18279401802928455,0.1798745724059293,0.26054732041049034,0.5595781071835804
City,Norwalk,Connecticut,"Bridgeport, CT",7500,7500,7502,22502,182,94,740,1016,43856851,39686310,1060026394,1143569555,819303.5,0.024266666666666666,0.012533333333333334,0.09864036256998134,0.04515154208514799,0.17913385826771652,0.09251968503937008,0.7283464566929134
City,Oak Harbor,Washington,"Oak Harbor, WA",4347,4347,4347,13041,49,60,233,342,11024547,17592652,141941450,170558649,465845.5,0.011272141706924315,0.013802622498274672,0.05360018403496664,0.026224982746721876,0.14327485380116958,0.17543859649122806,0.6812865497076024
City,Oceanside,New York,"New York, NY",3148,3148,3149,9445,1106,1270,1734,4110,447940508,626295248,1181614042,2255849798,506226,0.3513341804320203,0.403430749682338,0.5506510003175611,0.4351508734780307,0.26909975669099756,0.30900243309002434,0.4218978102189781
City,Palm City,Florida,"Port Saint Lucie, FL",4131,4132,4130,12393,220,152,458,830,45407107,55323637,316256175,416986919,499819,0.0532558702493343,0.036786060019361085,0.1108958837772397,0.06697329137416283,0.26506024096385544,0.18313253012048192,0.5518072289156627
City,Palm Coast,Florida,"Palm Coast, FL",12621,12621,12623,37865,189,171,1205,1565,26311873,36420256,570652225,633384354,350887,0.014975041597337771,0.013548847159496079,0.09546066703636219,0.041331044500198075,0.1207667731629393,0.10926517571884985,0.7699680511182109
City,Panacea,Florida,"Tallahassee, FL",639,639,640,1918,205,331,295,831,19805994,69461484,129868130,219135608,233934,0.3208137715179969,0.5179968701095462,0.4609375,0.43326381647549533,0.246690734055355,0.3983152827918171,0.35499398315282793
City,Pleasantville,New Jersey,"Egg Harbor Township, NJ",1599,1599,1601,4799,76,48,71,195,6578452,5037604,12234112,23850168,102554,0.047529706066291436,0.0300187617260788,0.0443472829481574,0.04063346530527193,0.38974358974358975,0.24615384615384617,0.3641025641025641
City,Pompano Beach,Florida,"Miami, FL",14326,14326,14327,42979,3404,2726,7240,13370,393894954,546833310,3812444678,4753172942,273897.5,0.23760993996928662,0.1902834008097166,0.5053395686466113,0.31108215640196374,0.25459985041136873,0.20388930441286462,0.5415108451757666
City,Port Orchard,Washington,"Bremerton, WA",7113,7113,7113,21339,11,32,257,300,2627401,9765598,161829065,174222064,532007,0.0015464642204414453,0.004498805004920568,0.036131027695768314,0.014058765640376775,0.03666666666666667,0.10666666666666667,0.8566666666666667
City,Reserve,Louisiana,"New Orleans, LA",552,552,553,1657,43,45,109,197,2981476,4304281,18339057,25624814,124805,0.07789855072463768,0.08152173913043478,0.19710669077757687,0.11888955944477972,0.2182741116751269,0.22842639593908629,0.5532994923857868
City,Roper,North Carolina,NA,289,289,291,869,11,58,50,119,694633,6091720,11668635,18454988,125714,0.03806228373702422,0.20069204152249134,0.1718213058419244,0.13693901035673187,0.09243697478991597,0.48739495798319327,0.42016806722689076
City,Rye,New Hampshire,"Boston, MA",885,885,886,2656,100,146,202,448,46846319,108885150,304959108,460690577,825623.5,0.11299435028248588,0.16497175141242937,0.22799097065462753,0.1686746987951807,0.22321428571428573,0.32589285714285715,0.45089285714285715
City,Sabine Pass,Texas,"Beaumont, TX",57,57,58,172,55,56,58,169,3295128,4247349,7714356,15256833,74615,0.9649122807017544,0.9824561403508771,1,0.9825581395348837,0.3254437869822485,0.33136094674556216,0.3431952662721893
City,Safety Harbor,Florida,"Tampa, FL",2417,2417,2419,7253,22,15,74,111,3003072,3822738,58900150,65725960,368777,0.009102192800992967,0.006206040546131568,0.03059115336916081,0.01530401213291052,0.1981981981981982,0.13513513513513514,0.6666666666666666
City,Saint Augustine,Florida,"Jacksonville, FL",13710,13710,13712,41132,2041,1735,2748,6524,265315648,383321906,1436803750,2085441304,237651,0.1488694383661561,0.12654996353026987,0.20040840140023336,0.15861130020422057,0.312844880441447,0.2659411404046597,0.4212139791538933
City,Saint Petersburg,Florida,"Tampa, FL",31457,31457,31459,94373,8647,5865,10391,24903,796204671,1110514341,5963235070,7869954082,201769,0.2748831738563754,0.18644498839685922,0.3303029339775581,0.2638784398079959,0.3472272416977874,0.23551379351885315,0.41725896478335944
City,Saraland,Alabama,"Mobile, AL",1933,1933,1934,5800,82,21,17,120,5220471,2649357,3697004,11566832,72770.5,0.04242110708742887,0.010863942058975685,0.008790072388831437,0.020689655172413793,0.6833333333333333,0.175,0.14166666666666666
City,Sea Island,Georgia,"Brunswick, GA",318,318,320,956,210,245,271,726,248099755,570759811,1063879210,1882738776,2474832.5,0.660377358490566,0.7704402515723271,0.846875,0.7594142259414226,0.2892561983471074,0.33746556473829203,0.37327823691460055
City,Seabrook,South Carolina,"Bluffton, SC",428,428,428,1284,100,124,121,345,13129951,22716249,61185010,97031210,180476,0.2336448598130841,0.2897196261682243,0.2827102803738318,0.26869158878504673,0.2898550724637681,0.35942028985507246,0.3507246376811594
City,South River,New Jersey,"New York, NY",1488,1488,1488,4464,90,31,14,135,19187866,8177483,4599014,31964363,233406,0.06048387096774194,0.020833333333333332,0.009408602150537635,0.03024193548387097,0.6666666666666666,0.22962962962962963,0.1037037037037037
City,Southern Shores,North Carolina,"Kill Devil Hills, NC",386,386,386,1158,126,93,105,324,39887440,38095382,66586036,144568858,401662,0.32642487046632124,0.24093264248704663,0.27202072538860106,0.27979274611398963,0.3888888888888889,0.28703703703703703,0.32407407407407407
City,Stamford,Connecticut,"Bridgeport, CT",10861,10861,10863,32585,364,415,392,1171,106183817,194162089,539600450,839946356,463233,0.0335144093545714,0.038210109566338274,0.03608579582067569,0.035936780727328525,0.3108454312553373,0.35439795046968403,0.33475661827497866
City,Tacoma,Washington,"Seattle, WA",20797,20797,20799,62393,1,9,242,252,184172,2395038,128470712,131049922,382954,4.808385824878588e-5,4.3275472423907294e-4,0.011635174768017693,0.004038914621832577,0.003968253968253968,0.03571428571428571,0.9603174603174603
City,Tillamook,Oregon,NA,1883,1883,1883,5649,40,36,29,105,6188419,9029917,11667173,26885509,231092,0.021242697822623474,0.019118428040361127,0.015400955921402018,0.01858736059479554,0.38095238095238093,0.34285714285714286,0.2761904761904762
City,Vacherie,Louisiana,"New Orleans, LA",678,678,678,2034,280,289,287,856,34817399,43125526,55459074,133401999,148297,0.41297935103244837,0.42625368731563423,0.42330383480825956,0.42084562438544737,0.32710280373831774,0.33761682242990654,0.3352803738317757
City,Valley Stream,New York,"New York, NY",5476,5476,5476,16428,461,302,1686,2449,180369298,137825157,1143301128,1461495583,578427,0.08418553688823958,0.05514974433893353,0.3078889700511322,0.14907475042610177,0.18824009799918334,0.12331563903634137,0.6884442629644753
City,Vandemere,North Carolina,"New Bern, NC",43,43,44,130,33,41,43,117,1617087,3416581,11683155,16716823,84766,0.7674418604651163,0.9534883720930233,0.9772727272727273,0.9,0.28205128205128205,0.3504273504273504,0.36752136752136755
City,Welaka,Florida,"Palatka, FL",314,314,315,943,7,124,162,293,444985,15470129,32739653,48654767,137948,0.022292993630573247,0.39490445859872614,0.5142857142857142,0.3107104984093319,0.023890784982935155,0.4232081911262799,0.552901023890785
City,West Haven,Connecticut,"New Haven, CT",4724,4724,4725,14173,340,79,121,540,48342416,14094616,40321713,102758745,154307,0.07197290431837426,0.01672311600338696,0.025608465608465608,0.03810061384322303,0.6296296296296297,0.14629629629629629,0.22407407407407406
City,West River,Maryland,"Baltimore, MD",282,282,284,848,37,23,85,145,11348664,11124145,72257012,94729821,625003,0.13120567375886524,0.08156028368794327,0.2992957746478873,0.17099056603773585,0.25517241379310346,0.15862068965517243,0.5862068965517241
City,Wildwood,New Jersey,"Upper Township, NJ",1503,1501,1504,4508,1497,1500,1502,4499,243286817,334193432,531484246,1108964495,223509,0.9960079840319361,0.9993337774816788,0.9986702127659575,0.9980035492457853,0.3327406090242276,0.33340742387197153,0.33385196710380083
City,Winthrop,Massachusetts,"Boston, MA",1593,1593,1594,4780,412,358,411,1181,138862897,173676393,318231860,630771150,485967,0.258631512868801,0.22473320778405526,0.2578419071518193,0.24707112970711298,0.3488569009314141,0.30313293818797626,0.34801016088060965
City,Yankeetown,Florida,NA,143,143,143,429,106,96,93,295,8967001,13583138,25888262,48438401,137614,0.7412587412587412,0.6713286713286714,0.6503496503496503,0.6876456876456877,0.3593220338983051,0.3254237288135593,0.3152542372881356
City,Carolina Beach,North Carolina,"Wilmington, NC",2368,2368,2369,7105,1096,825,931,2852,192190065,220927372,491619505,904736942,257943.5,0.46283783783783783,0.3483952702702703,0.3929928239763613,0.40140745953553836,0.38429172510518933,0.28927068723702665,0.326437587657784
City,Astor,Florida,"Orlando, FL",534,534,535,1603,2,108,206,316,125080,13778237,57452529,71355846,195656,0.003745318352059925,0.20224719101123595,0.3850467289719626,0.19713038053649407,0.006329113924050633,0.34177215189873417,0.6518987341772152
City,Crescent City,Florida,"Palatka, FL",1280,1280,1280,3840,10,60,199,269,367696,3842879,43198813,47409388,143502,0.0078125,0.046875,0.15546875,0.07005208333333333,0.03717472118959108,0.22304832713754646,0.7397769516728625
City,Beach Haven West,New Jersey,"New York, NY",1495,1495,1497,4487,1172,1229,1355,3756,297895275,413798428,654402369,1366096072,337563,0.7839464882943143,0.8220735785953177,0.9051436205744823,0.8370849119679072,0.31203407880724177,0.327209797657082,0.36075612353567627
City,Belhaven,North Carolina,"Washington, NC",89,89,90,268,85,79,75,239,5019789,8399710,16836848,30256347,98879,0.9550561797752809,0.8876404494382022,0.8333333333333334,0.8917910447761194,0.35564853556485354,0.3305439330543933,0.3138075313807531
City,Lafitte,Louisiana,"New Orleans, LA",104,104,105,313,103,99,102,304,10874813,15012641,24048238,49935692,150983,0.9903846153846154,0.9519230769230769,0.9714285714285714,0.9712460063897763,0.33881578947368424,0.3256578947368421,0.3355263157894737
City,Everglades,Florida,"Naples, FL",107,107,107,321,107,107,107,321,15232267,29256930,54028460,98517657,265109,1,1,1,1,0.3333333333333333,0.3333333333333333,0.3333333333333333
City,Grasonville,Maryland,"Baltimore, MD",769,769,770,2308,221,301,322,844,50480836,113831406,204758466,369070708,417322,0.28738621586475943,0.3914174252275683,0.41818181818181815,0.36568457538994803,0.2618483412322275,0.3566350710900474,0.3815165876777251
City,Gray,Louisiana,"Houma, LA",854,854,854,2562,321,302,425,1048,32017648,44694149,98061607,174773404,156116,0.3758782201405152,0.35362997658079626,0.49765807962529274,0.4090554254488681,0.3062977099236641,0.2881679389312977,0.40553435114503816
City,Dickinson,Texas,"Houston, TX",2087,2087,2089,6263,42,47,74,163,4058481,7021755,22087668,33167904,163396,0.020124580737901295,0.022520364159080018,0.03542364767831498,0.02602586619830752,0.25766871165644173,0.2883435582822086,0.4539877300613497
City,Hahnville,Louisiana,"New Orleans, LA",250,250,251,751,16,16,96,128,2513937,3904311,30991896,37410144,293883.5,0.064,0.064,0.38247011952191234,0.170439414114514,0.125,0.125,0.75
City,Malden,Massachusetts,"Boston, MA",3520,3520,3521,10561,401,229,216,846,129645157,99468447,158153297,387266901,390747.5,0.11392045454545455,0.06505681818181819,0.061346208463504685,0.08010605056339362,0.4739952718676123,0.2706855791962175,0.2553191489361702
City,Oxford,Maryland,"Easton, MD",301,301,301,903,179,136,101,416,54011325,82764585,158079468,294855378,484305.5,0.5946843853820598,0.45182724252491696,0.33554817275747506,0.46068660022148394,0.43028846153846156,0.3269230769230769,0.24278846153846154
City,Steinhatchee,Florida,NA,516,516,516,1548,81,156,243,480,4995350,15615268,57876707,78487325,117105,0.1569767441860465,0.3023255813953488,0.47093023255813954,0.31007751937984496,0.16875,0.325,0.50625
City,Vashon,Washington,"Seattle, WA",1680,1680,1680,5040,44,68,119,231,18429146,38595269,116733547,173757962,654208,0.02619047619047619,0.04047619047619048,0.07083333333333333,0.04583333333333333,0.19047619047619047,0.2943722943722944,0.5151515151515151
City,Seaside Heights,New Jersey,"New York, NY",597,597,597,1791,593,539,470,1602,100832041,137739284,185450758,424022083,242898.5,0.9932998324958124,0.9028475711892797,0.7872696817420436,0.8944723618090452,0.3701622971285893,0.3364544319600499,0.2933832709113608
City,Warrenton,Oregon,"Astoria, OR",718,718,719,2155,448,146,24,618,95314025,40682404,10415639,146412068,230985,0.6239554317548747,0.20334261838440112,0.03337969401947149,0.28677494199535963,0.7249190938511327,0.23624595469255663,0.038834951456310676
City,South Pasadena,Florida,"Tampa, FL",943,943,943,2829,806,646,541,1993,101195642,131623236,241302726,474121604,189308,0.8547189819724285,0.6850477200424178,0.5737009544008483,0.7044892188052315,0.4044154540893126,0.3241344706472654,0.27145007526342196
City,Saint Simons Island,Georgia,"Brunswick, GA",4050,4050,4050,12150,1193,1561,2323,5077,265109202,564937790,1781817588,2611864580,412484,0.2945679012345679,0.3854320987654321,0.5735802469135802,0.41786008230452676,0.23498128816230057,0.307465038408509,0.45755367342919046
City,Ocean Gate,New Jersey,"New York, NY",339,339,340,1018,257,246,279,782,36670358,49180078,105690638,191541074,203910,0.7581120943952803,0.7256637168141593,0.8205882352941176,0.768172888015717,0.32864450127877237,0.3145780051150895,0.3567774936061381
City,Belleair,Florida,"Tampa, FL",760,760,761,2281,45,88,190,323,11417948,28717299,271705987,311841234,647009,0.05921052631578947,0.11578947368421053,0.24967148488830487,0.14160455940377029,0.1393188854489164,0.2724458204334365,0.5882352941176471
City,Riverhead,New York,"New York, NY",3021,3021,3023,9065,62,128,291,481,16606650,44802518,242248010,303657178,474024,0.020523005627275735,0.042370076133730554,0.09626199139927225,0.053061224489795916,0.1288981288981289,0.2661122661122661,0.604989604989605
City,Davis,North Carolina,"Morehead City, NC",71,71,72,214,71,71,72,214,6131561,9359504,22683374,38174439,122905.5,1,1,1,1,0.3317757009345794,0.3317757009345794,0.3364485981308411
City,El Lago,Texas,"Houston, TX",397,397,399,1193,141,1,1,143,10649194,177641,682273,11509108,66729,0.35516372795969775,0.0025188916876574307,0.002506265664160401,0.11986588432523052,0.986013986013986,0.006993006993006993,0.006993006993006993
City,Georgetown,Florida,"Palatka, FL",225,225,225,675,22,22,70,114,901147,1432230,14731744,17065121,128951,0.09777777777777778,0.09777777777777778,0.3111111111111111,0.1688888888888889,0.19298245614035087,0.19298245614035087,0.6140350877192983
City,Dagsboro,Delaware,"Salisbury, MD",1137,1137,1137,3411,20,99,179,298,3629022,26690204,76971300,107290526,309571,0.01759014951627089,0.0870712401055409,0.15743183817062445,0.08736440926414542,0.06711409395973154,0.33221476510067116,0.6006711409395973
City,Cutchogue,New York,"New York, NY",706,706,708,2120,54,51,95,200,28663835,36106487,160799958,225570280,799109,0.0764872521246459,0.07223796033994334,0.134180790960452,0.09433962264150944,0.27,0.255,0.475
City,Aberdeen,Washington,"Aberdeen, WA",2799,2799,2799,8397,2412,1145,255,3812,191157282,134625389,64053930,389836601,87694,0.8617363344051447,0.4090746695248303,0.09110396570203644,0.4539716565440038,0.6327387198321092,0.3003672612801679,0.06689401888772298
City,Amagansett,New York,"New York, NY",617,617,617,1851,71,48,65,184,110063400,127311533,303909746,541284679,2497279,0.11507293354943274,0.07779578606158834,0.1053484602917342,0.09940572663425176,0.3858695652173913,0.2608695652173913,0.3532608695652174
City,Baldwin,New York,"New York, NY",3188,3188,3188,9564,365,492,828,1685,128156590,209266832,466881346,804304768,445308,0.11449184441656211,0.15432873274780426,0.25972396486825594,0.17618151401087412,0.2166172106824926,0.29198813056379824,0.4913946587537092
City,Bonita Springs,Florida,"Fort Myers, FL",11956,11956,11957,35869,603,765,2722,4090,124272393,273179598,3463145555,3860597546,574058,0.05043492806958849,0.06398461023753764,0.22764907585514763,0.11402603919819343,0.1474327628361858,0.18704156479217604,0.6655256723716382
City,Bourg,Louisiana,"Houma, LA",543,543,545,1631,474,421,166,1061,58167426,67134574,39052300,164354300,146070,0.8729281767955801,0.7753222836095764,0.30458715596330277,0.6505211526670754,0.4467483506126296,0.39679547596606973,0.15645617342130066
City,Boynton Beach,Florida,"Miami, FL",23602,23602,23603,70807,2386,657,658,3701,282579665,150804544,385934990,819319199,151070,0.10109312770104228,0.02783662401491399,0.027877812142524255,0.05226884347592752,0.6446906241556336,0.17751958930018913,0.17778978654417724
City,Bridge City,Texas,"Beaumont, TX",1131,1131,1133,3395,211,240,284,735,17729854,31218515,67450932,116399301,134942,0.1865605658709107,0.21220159151193635,0.2506619593998235,0.21649484536082475,0.2870748299319728,0.32653061224489793,0.38639455782312926
City,Brielle,New Jersey,"New York, NY",654,654,655,1963,57,63,97,217,24340413,38187933,164118268,226646614,655940,0.0871559633027523,0.0963302752293578,0.1480916030534351,0.11054508405501783,0.2626728110599078,0.2903225806451613,0.4470046082949309
City,Cape Carteret,North Carolina,"Morehead City, NC",327,327,328,982,17,9,104,130,2927994,2229021,59547296,64704311,456950.5,0.05198776758409786,0.027522935779816515,0.3170731707317073,0.13238289205702647,0.13076923076923078,0.06923076923076923,0.8
City,Cape Coral,Florida,"Fort Myers, FL",25461,25459,25462,76382,3001,1798,4649,9448,430160380,406561757,2309835358,3146557495,283143.5,0.11786654098425042,0.07062335519855453,0.1825858141544262,0.1236940640465031,0.3176333615580017,0.19030482641828958,0.49206181202370874
City,Cedar Key,Florida,NA,396,396,397,1189,86,184,244,514,9837099,38818038,89430891,138086028,267272,0.21717171717171718,0.46464646464646464,0.6146095717884131,0.432296047098402,0.16731517509727625,0.35797665369649806,0.47470817120622566
City,Charlestown,Rhode Island,"Providence, RI",1612,1612,1612,4836,6,33,326,365,1798792,13281803,296965840,312046435,789284,0.0037220843672456576,0.020471464019851116,0.2022332506203474,0.07547559966914806,0.01643835616438356,0.09041095890410959,0.8931506849315068
City,Chesapeake Beach,Maryland,"Washington, DC",1758,1758,1759,5275,94,90,124,308,21534075,27889884,64374569,113798528,314437,0.053469852104664393,0.051194539249146756,0.07049459920409323,0.05838862559241706,0.3051948051948052,0.2922077922077922,0.4025974025974026
City,Chestertown,Maryland,NA,2172,2172,2173,6517,19,48,151,218,2849654,9989373,85478031,98317058,366506,0.008747697974217311,0.022099447513812154,0.06948918545789232,0.03345097437471229,0.0871559633027523,0.22018348623853212,0.6926605504587156
City,Chickasaw,Alabama,"Mobile, AL",879,879,880,2638,5,3,103,111,212649,195730,14124101,14532480,125310,0.005688282138794084,0.0034129692832764505,0.11704545454545455,0.0420773313115997,0.04504504504504504,0.02702702702702703,0.9279279279279279
City,Chokoloskee,Florida,"Naples, FL",75,75,75,225,36,53,60,149,4897753,11938881,27280430,44117064,251689,0.48,0.7066666666666667,0.8,0.6622222222222223,0.24161073825503357,0.35570469798657717,0.40268456375838924
City,Conway,South Carolina,"Conway, SC",8108,8109,8108,24325,55,129,242,426,5415620,17429484,60736026,83581130,166514,0.00678342377898372,0.015908250092489827,0.029847064627528366,0.01751284686536485,0.12910798122065728,0.3028169014084507,0.568075117370892
City,Crapo,Maryland,"Cambridge, MD",53,53,53,159,53,53,53,159,4734957,6200851,12614646,23550454,114996,1,1,1,1,0.3333333333333333,0.3333333333333333,0.3333333333333333
City,Crisfield,Maryland,"Salisbury, MD",1098,1098,1100,3296,1089,1097,1095,3281,68343137,86819757,200030681,355193575,76997,0.9918032786885246,0.9990892531876139,0.9954545454545455,0.9954490291262136,0.3319110027430661,0.33434928375495276,0.3337397135019811
City,Danvers,Massachusetts,"Boston, MA",2777,2777,2779,8333,64,24,64,152,12400477,10361729,53111506,75873712,424858,0.023046453006841917,0.008642419877565718,0.023029866858582222,0.018240729629185166,0.42105263157894735,0.15789473684210525,0.42105263157894735
City,Deale,Maryland,"Baltimore, MD",378,378,380,1136,118,96,150,364,32798828,34756068,96542402,164097298,375613.5,0.31216931216931215,0.25396825396825395,0.39473684210526316,0.3204225352112676,0.3241758241758242,0.26373626373626374,0.41208791208791207
City,Delray Beach,Florida,"Miami, FL",20728,20728,20729,62185,10,885,3244,4139,1190311,199211328,3627417812,3827819451,529162,4.8243921265920495e-4,0.04269587032033964,0.15649573061893965,0.06655945967677093,0.0024160425223483935,0.2138197632278328,0.7837641942498188
City,Deltaville,Virginia,NA,689,689,690,2068,75,162,134,371,13226101,44337224,66582586,124145911,290524,0.10885341074020319,0.2351233671988389,0.19420289855072465,0.17940038684719536,0.20215633423180593,0.4366576819407008,0.3611859838274933
City,Dennis,Massachusetts,"East Falmouth, MA",4695,4695,4696,14086,284,215,320,819,59547070,78085781,259856968,397489819,369433,0.060489882854100105,0.04579339723109691,0.06814310051107325,0.05814283685929292,0.34676434676434675,0.2625152625152625,0.3907203907203907
City,Dowell,Maryland,"Washington, DC",238,238,239,715,48,53,73,174,11064591,15635431,27104125,53804147,324184.5,0.20168067226890757,0.22268907563025211,0.3054393305439331,0.24335664335664337,0.27586206896551724,0.3045977011494253,0.41954022988505746
City,Elizabeth,New Jersey,"New York, NY",4870,4870,4872,14612,136,55,27,218,27477599,14078926,9525389,51081914,226161.5,0.02792607802874743,0.011293634496919919,0.005541871921182266,0.014919244456611004,0.6238532110091743,0.25229357798165136,0.12385321100917432
City,Fairfield,Connecticut,"Bridgeport, CT",6491,6491,6492,19474,273,827,1182,2282,113175213,462673271,1389251195,1965099679,698743.5,0.042058234478508705,0.12740717917116007,0.18207024029574861,0.11718188353702372,0.1196319018404908,0.3624014022787029,0.5179666958808063
City,Flagler Beach,Florida,"Palm Coast, FL",1168,1168,1168,3504,425,496,543,1464,83679040,149640698,284211964,517531702,315614.5,0.3638698630136986,0.4246575342465753,0.4648972602739726,0.4178082191780822,0.29030054644808745,0.33879781420765026,0.3709016393442623
City,Fort Lauderdale,Florida,"Miami, FL",22252,22252,22253,66757,11360,13503,12548,37411,1836557065,4091556783,14458949474,20387063322,300297,0.5105159086823656,0.6068218587093295,0.5638790275468476,0.5604056503437842,0.30365400550640187,0.360936622918393,0.3354093715752052
City,Fort Myers,Florida,"Fort Myers, FL",35866,35866,35868,107600,6206,3753,5205,15164,654070612,782963471,2857561497,4294595580,193573,0.1730329560028997,0.10463949144036135,0.1451154232184677,0.14092936802973977,0.40925877077288314,0.2474940648905302,0.34324716433658664
City,Grandy,North Carolina,"Virginia Beach, VA",217,217,217,651,107,75,31,213,14560484,13993917,8745705,37300106,157287,0.4930875576036866,0.3456221198156682,0.14285714285714285,0.3271889400921659,0.5023474178403756,0.352112676056338,0.14553990610328638
City,Gulfport,Mississippi,"Gulfport, MS",8847,8847,8847,26541,11,45,157,213,738767,4472574,49332007,54543348,217854,0.0012433593308466147,0.00508646998982706,0.017746128631174408,0.008025319317282694,0.051643192488262914,0.2112676056338028,0.7370892018779343
City,Hansville,Washington,"Bremerton, WA",464,464,465,1393,15,46,157,218,3896471,22325802,121178260,147400533,637570.5,0.032327586206896554,0.09913793103448276,0.33763440860215055,0.15649676956209618,0.06880733944954129,0.21100917431192662,0.7201834862385321
City,Highlands,Texas,"Houston, TX",1380,1380,1382,4142,21,68,18,107,1919962,7555082,4458576,13933620,108222,0.015217391304347827,0.04927536231884058,0.013024602026049204,0.02583293095123129,0.19626168224299065,0.6355140186915887,0.16822429906542055
City,Hollywood,Florida,"Miami, FL",17173,17173,17175,51521,4552,7083,9453,21088,596684914,1821450801,5599418851,8017554566,294930,0.26506725674023174,0.4124497758108659,0.5503930131004366,0.40930882552745484,0.21585735963581185,0.33587822458270106,0.4482644157814871
City,Indian River Shores,Florida,"Vero Beach, FL",1170,1170,1171,3511,254,258,361,873,85469627,218597063,986969398,1291036088,969358,0.2170940170940171,0.2205128205128205,0.30828351836037576,0.24864710908573057,0.290950744558992,0.29553264604810997,0.413516609392898
City,Ingleside on the Bay,Texas,"Corpus Christi, TX",113,113,113,339,35,49,61,145,4668312,9470706,18508351,32647369,212314,0.30973451327433627,0.4336283185840708,0.5398230088495575,0.4277286135693215,0.2413793103448276,0.33793103448275863,0.4206896551724138
City,Town of Islip,New York,"New York, NY",26947,26945,26946,80838,149,401,5243,5793,43654031,148845203,3977065728,4169564962,595482,0.005529372471889264,0.014882167377992207,0.19457433385289097,0.07166184220292436,0.025720697393405833,0.06922147419299154,0.9050578284136026
City,Jacksonville Beach,Florida,"Jacksonville, FL",3397,3397,3398,10192,1052,480,484,2016,161921158,171690710,293222358,626834226,281812.5,0.30968501619075656,0.1413011480718281,0.14243672748675693,0.1978021978021978,0.5218253968253969,0.23809523809523808,0.2400793650793651
City,Kiawah Island,South Carolina,"Charleston, SC",1195,1195,1197,3587,1163,1142,1061,3366,538619713,1205972769,3284621579,5029214061,1024587,0.9732217573221758,0.9556485355648535,0.8863826232247285,0.9383886255924171,0.345513963161022,0.3392751039809863,0.3152109328579917
City,La Marque,Texas,"Houston, TX",2022,2022,2024,6068,0,0,226,226,0,0,65134536,65134536,271528,0,0,0.11166007905138339,0.03724456163480554,0,0,1
City,Lamont,Florida,"Tallahassee, FL",185,185,187,557,82,35,29,146,3430221,3018347,4753483,11202051,51642,0.44324324324324327,0.1891891891891892,0.15508021390374332,0.2621184919210054,0.5616438356164384,0.23972602739726026,0.19863013698630136
City,Lauderdale Lakes,Florida,"Miami, FL",3921,3921,3923,11765,299,501,78,878,15231891,33387867,16226156,64845914,61195,0.07625605712828361,0.12777352716143842,0.01988274279887841,0.07462813429664258,0.34054669703872437,0.570615034168565,0.0888382687927107
City,Madison,Connecticut,"New Haven, CT",2369,2369,2371,7109,49,40,259,348,15938941,18431992,320672636,355043569,770410,0.020683832840861123,0.016884761502743775,0.10923660902572754,0.048952032634688426,0.14080459770114942,0.11494252873563218,0.7442528735632183
City,Madison,Maryland,"Cambridge, MD",56,56,57,169,56,56,57,169,7160035,10484868,19464166,37109069,186987,1,1,1,1,0.33136094674556216,0.33136094674556216,0.33727810650887574
City,Mantoloking,New Jersey,"New York, NY",169,169,169,507,168,165,77,410,232776267,434744019,344957924,1012478210,2287751,0.9940828402366864,0.9763313609467456,0.4556213017751479,0.8086785009861933,0.4097560975609756,0.4024390243902439,0.1878048780487805
City,Mashpee,Massachusetts,"East Falmouth, MA",3199,3199,3199,9597,0,42,248,290,0,18638737,338401380,357040117,1017954.5,0,0.01312910284463895,0.07752422632072523,0.030217776388454725,0,0.14482758620689656,0.8551724137931035
City,Melbourne Beach,Florida,"Palm Bay, FL",2183,2183,2185,6551,544,410,739,1693,93302359,153722440,516068138,763092937,415256,0.24919835089326614,0.18781493357764545,0.3382151029748284,0.258433826896657,0.32132309509746015,0.24217365623154163,0.4365032486709982
City,Miami Shores,Florida,"Miami, FL",1253,1253,1253,3759,181,88,343,612,48481568,43828957,454729680,547040205,701103.5,0.14445331205107742,0.07023144453312051,0.2737430167597765,0.16280925778132482,0.2957516339869281,0.1437908496732026,0.5604575163398693
City,Mobile,Alabama,"Mobile, AL",29458,29458,29459,88375,503,203,453,1159,24336139,21785742,139697155,185819036,101365,0.01707515785185688,0.006891167085341842,0.015377304049696188,0.013114568599717115,0.4339948231233822,0.17515099223468508,0.3908541846419327
City,Moonachie,New Jersey,"New York, NY",208,208,208,624,208,207,206,621,86178989,116568944,145805317,348553250,568009,1,0.9951923076923077,0.9903846153846154,0.9951923076923077,0.33494363929146537,0.3333333333333333,0.33172302737520126
City,Moss Point,Mississippi,"Gulfport, MS",3672,3672,3674,11018,356,276,186,818,16795965,22131574,32775090,71702629,71053.5,0.09694989106753812,0.07516339869281045,0.05062602068590093,0.07424214921038301,0.4352078239608802,0.3374083129584352,0.2273838630806846
City,Mount Vernon,Washington,"Mount Vernon, WA",5250,5250,5252,15752,50,108,174,332,10558037,30940640,78905071,120403748,336633.5,0.009523809523809525,0.02057142857142857,0.03313023610053313,0.021076688674454037,0.15060240963855423,0.3253012048192771,0.5240963855421686
City,New Bedford,Massachusetts,"Providence, RI",6415,6415,6415,19245,74,44,51,169,12024213,9825218,20483472,42332903,213917,0.011535463756819953,0.006858924395946999,0.007950116913484021,0.008781501688750325,0.4378698224852071,0.2603550295857988,0.30177514792899407
City,North Beach,Maryland,"Washington, DC",629,629,631,1889,52,88,170,310,10764712,24544667,80725264,116034643,321330.5,0.08267090620031796,0.13990461049284578,0.2694136291600634,0.1641079936474325,0.16774193548387098,0.2838709677419355,0.5483870967741935
City,North Fort Myers,Florida,"Fort Myers, FL",7283,7283,7285,21851,650,1507,1925,4082,49586304,212077226,688139009,949802539,187921.5,0.08924893587807223,0.2069202251819305,0.26424159231297184,0.18681067228044482,0.1592356687898089,0.36918177364037236,0.4715825575698187
City,North Palm Beach,Florida,"Miami, FL",2609,2609,2610,7828,689,543,861,2093,115544164,175646416,1758017153,2049207733,352445,0.2640858566500575,0.20812571866615562,0.32988505747126434,0.2673735309146653,0.32919254658385094,0.2594362159579551,0.411371237458194
City,North Wildwood,New Jersey,"Upper Township, NJ",2467,2467,2468,7402,2139,2362,2313,6814,425564958,753712668,1152229655,2331507281,325957,0.8670449939197405,0.9574381840291852,0.9371961102106969,0.9205620102674953,0.3139125330202524,0.34663927208687995,0.33944819489286765
City,Ocean Shores,Washington,"Aberdeen, WA",3199,3199,3201,9599,151,101,92,344,15942339,14629534,19783889,50355762,137670,0.04720225070334479,0.0315723663644889,0.02874101843174008,0.03583706636107928,0.438953488372093,0.2936046511627907,0.26744186046511625
City,Old Orchard Beach,Maine,"Portland, ME",1914,1914,1915,5743,111,230,314,655,17326551,52094023,126425270,195845844,267231,0.05799373040752351,0.12016718913270637,0.1639686684073107,0.11405188925648616,0.16946564885496182,0.3511450381679389,0.47938931297709925
City,Ormond Beach,Florida,"Palm Coast, FL",7045,7043,7046,21134,1110,616,794,2520,164602454,129610888,531619159,825832501,192942.5,0.15755855216465578,0.08746272895073122,0.11268804995742265,0.1192391407211129,0.44047619047619047,0.24444444444444444,0.31507936507936507
City,Palmetto,Florida,"Bradenton, FL",5121,5121,5121,15363,1166,820,1186,3172,92309267,142182991,572338209,806830467,172115.5,0.22768990431556338,0.16012497559070493,0.23159539152509276,0.20647009047712037,0.36759142496847413,0.25851197982345525,0.3738965952080706
City,Pasadena,Maryland,"Baltimore, MD",8018,8014,8018,24050,46,113,364,523,11324419,36361667,218499872,266185958,444393,0.005737091544025941,0.014100324432243573,0.04539785482664006,0.021746361746361745,0.08795411089866156,0.21606118546845124,0.6959847036328872
City,Pierre Part,Louisiana,NA,499,499,499,1497,490,480,483,1453,52501507,63197400,107729322,223428229,129879,0.9819639278557114,0.9619238476953907,0.9679358717434869,0.9706078824315297,0.3372333103922918,0.33035099793530626,0.3324156916724019
City,Pinecrest,Florida,"Miami, FL",2004,2004,2004,6012,206,59,33,298,42000963,61153977,59343880,162498820,214308,0.1027944111776447,0.02944111776447106,0.016467065868263474,0.049567531603459745,0.6912751677852349,0.19798657718120805,0.11073825503355705
City,Plantation,Florida,"Miami, FL",10014,10014,10014,30042,2448,993,1937,5378,295501962,309315838,980196004,1585013804,251055.5,0.2444577591372079,0.09916117435590174,0.19342919912123027,0.17901604420477998,0.45518780215693566,0.1846411305317962,0.36017106731126813
City,Ponchatoula,Louisiana,"Hammond, LA",2748,2748,2749,8245,60,47,47,154,7604599,7601099,11271378,26477076,156964.5,0.021834061135371178,0.01710334788937409,0.01709712622771917,0.018677986658580958,0.38961038961038963,0.3051948051948052,0.3051948051948052
City,Port Isabel,Texas,"Brownsville, TX",790,790,792,2372,517,483,482,1482,44541821,64309945,122128186,230979952,128125.5,0.6544303797468355,0.6113924050632912,0.6085858585858586,0.6247892074198989,0.34885290148448045,0.3259109311740891,0.3252361673414305
City,Port Orange,Florida,"Palm Coast, FL",6409,6409,6411,19229,938,607,506,2051,105693022,114113460,182537626,402344108,167059,0.14635668591043843,0.094710563270401,0.07892684448603962,0.10666181288678558,0.45733788395904434,0.2959531935641151,0.24670892247684056
City,Port Saint Lucie,Florida,"Port Saint Lucie, FL",26050,26050,26051,78151,165,41,63,269,23558449,8114361,37332986,69005796,158777,0.006333973128598848,0.0015738963531669865,0.002418333269356263,0.003442054484267636,0.6133828996282528,0.1524163568773234,0.2342007434944238
City,Port Wentworth,Georgia,"Savannah, GA",1020,1020,1021,3061,64,23,17,104,4941644,3024353,4953842,12919839,90057.5,0.06274509803921569,0.022549019607843137,0.01665034280117532,0.03397582489382555,0.6153846153846154,0.22115384615384615,0.16346153846153846
City,Portsmouth,Rhode Island,"Providence, RI",2443,2443,2444,7330,80,70,47,197,17355223,25722271,29491262,72568756,333662,0.03274662300450266,0.02865329512893983,0.019230769230769232,0.026875852660300136,0.40609137055837563,0.3553299492385787,0.23857868020304568
City,Ravenel,South Carolina,"Charleston, SC",355,355,357,1067,27,27,48,102,4071195,6045895,24070576,34187666,264188.5,0.07605633802816901,0.07605633802816901,0.13445378151260504,0.09559512652296158,0.2647058823529412,0.2647058823529412,0.47058823529411764
City,Redington Beach,Florida,"Tampa, FL",316,316,317,949,316,316,303,935,91000905,160676368,366147349,617824622,513431,1,1,0.9558359621451105,0.9852476290832455,0.33796791443850266,0.33796791443850266,0.3240641711229946
City,Ridge,Maryland,"Mechanicsville, MD",167,167,167,501,26,31,63,120,5934730,9729271,31558857,47222858,367142.5,0.15568862275449102,0.18562874251497005,0.3772455089820359,0.23952095808383234,0.21666666666666667,0.25833333333333336,0.525
City,Ridgeland,South Carolina,"Bluffton, SC",1532,1532,1533,4597,6,38,88,132,731435,5560938,30997081,37289454,230502,0.0039164490861618795,0.024804177545691905,0.05740378343118069,0.028714378942788776,0.045454545454545456,0.2878787878787879,0.6666666666666666
City,Ruskin,Florida,"Tampa, FL",2777,2777,2779,8333,624,311,694,1629,67561958,56849447,236392384,360803789,185901,0.22470291681670868,0.11199135758012244,0.249730118747751,0.19548781951278052,0.3830570902394107,0.19091467157765502,0.42602823818293434
City,Salem,Massachusetts,"Boston, MA",3749,3747,3749,11245,217,171,247,635,54898033,66061599,154326124,275285756,398211,0.057882101893838356,0.045636509207365894,0.06588423579621232,0.05646954201867497,0.3417322834645669,0.2692913385826772,0.3889763779527559
City,Salem,New Jersey,"Philadelphia, PA",515,515,515,1545,260,281,281,822,18380258,22565249,34009162,74954669,78395.5,0.5048543689320388,0.545631067961165,0.545631067961165,0.5320388349514563,0.31630170316301703,0.3418491484184915,0.3418491484184915
City,San Leon,Texas,"Houston, TX",766,766,766,2298,341,357,338,1036,27052950,46379125,114063187,187495262,132006.5,0.4451697127937337,0.4660574412532637,0.4412532637075718,0.45082680591818974,0.32915057915057916,0.34459459459459457,0.32625482625482627
City,Sea Ranch Lakes,Florida,"Miami, FL",80,80,81,241,22,46,62,130,23034320,64782891,153810497,241627708,1631201.5,0.275,0.575,0.7654320987654321,0.5394190871369294,0.16923076923076924,0.35384615384615387,0.47692307692307695
City,Seaford,New York,"New York, NY",2307,2305,2308,6920,461,437,689,1587,178903465,207547675,427995726,814446866,488258,0.199826614651062,0.18958785249457702,0.298526863084922,0.22933526011560693,0.2904851921865154,0.2753623188405797,0.43415248897290487
City,Seaside Park,New Jersey,"New York, NY",672,672,672,2016,443,538,400,1381,162709414,305532819,359297149,827539382,558632,0.6592261904761905,0.8005952380952381,0.5952380952380952,0.6850198412698413,0.32078204199855176,0.389572773352643,0.28964518464880523
City,Secaucus,New Jersey,"New York, NY",1586,1584,1586,4756,1106,537,458,2101,355063528,232884431,277046340,864994299,391859,0.6973518284993695,0.3390151515151515,0.28877679697351827,0.441757779646762,0.5264159923845788,0.2555925749643027,0.2179914326511185
City,Smithfield,Virginia,"Virginia Beach, VA",2251,2251,2252,6754,20,20,148,188,2987461,4648600,68564829,76200890,379356.5,0.00888494002665482,0.00888494002665482,0.06571936056838366,0.02783535682558484,0.10638297872340426,0.10638297872340426,0.7872340425531915
City,Smyrna,Delaware,"Dover, DE",4464,4464,4464,13392,128,39,24,191,13342658,7515756,9078029,29936443,110029,0.02867383512544803,0.008736559139784945,0.005376344086021506,0.014262246117084827,0.6701570680628273,0.20418848167539266,0.1256544502617801
City,Stock Island,Florida,"Key West, FL",241,241,243,725,241,241,243,725,60395947,87078234,129018582,276492763,370425,1,1,1,1,0.33241379310344826,0.33241379310344826,0.3351724137931035
City,Surfside,Florida,"Miami, FL",1072,1072,1073,3217,81,732,378,1191,26661438,488544726,539301739,1054507903,693413,0.07555970149253731,0.6828358208955224,0.35228331780055916,0.3702207025178738,0.06801007556675064,0.6146095717884131,0.31738035264483627
City,Thibodaux,Louisiana,"Houma, LA",4505,4505,4505,13515,2e3,1459,1672,5131,199679199,222285969,458915739,880880907,147118,0.4439511653718091,0.3238623751387347,0.37114317425083243,0.3796522382537921,0.38978756577665175,0.28435002923406744,0.3258624049892808
City,Tinicum Township,Pennsylvania,"Philadelphia, PA",537,537,539,1613,76,101,131,308,8094456,13266411,22381036,43741903,137464,0.14152700186219738,0.18808193668528864,0.24304267161410018,0.19094854308741477,0.24675324675324675,0.32792207792207795,0.4253246753246753
City,Toms River,New Jersey,"New York, NY",10821,10821,10821,32463,1861,1216,2843,5920,364436106,334239719,1516570262,2215246087,306753,0.17198040846502172,0.1123740874226042,0.2627298770908419,0.18236145765948927,0.3143581081081081,0.20540540540540542,0.4802364864864865
City,Topsail Beach,North Carolina,"Wilmington, NC",423,421,423,1267,361,318,323,1002,120160611,156681017,218542502,495384130,497621.5,0.8534278959810875,0.7553444180522565,0.7635933806146572,0.7908445146014207,0.3602794411177645,0.31736526946107785,0.3223552894211577
City,Treasure Island,Florida,"Tampa, FL",1758,1758,1759,5275,1756,1683,1615,5054,343199136,601479085,1339385371,2284063592,342641,0.9988623435722411,0.9573378839590444,0.9181353041500853,0.9581042654028435,0.34744756628413137,0.3330035615354175,0.31954887218045114
City,University Park,Florida,"Miami, FL",2275,2275,2276,6826,439,335,280,1054,80752548,109847249,142688045,333287842,306077,0.19296703296703296,0.14725274725274726,0.12302284710017575,0.15440961031350717,0.41650853889943074,0.3178368121442125,0.2656546489563567
City,Ventura,California,"Oxnard, CA",10819,10820,10819,32458,218,15,339,572,97147710,8177987,589860368,695186065,1133170,0.02014973657454478,0.0013863216266173752,0.03133376467326,0.01762277404646004,0.3811188811188811,0.026223776223776224,0.5926573426573427
City,Walterboro,South Carolina,NA,2689,2689,2689,8067,5,46,66,117,376074,3996448,11163560,15536082,119886,0.001859427296392711,0.017106731126812942,0.024544440312383786,0.014503532911863145,0.042735042735042736,0.39316239316239315,0.5641025641025641
City,Wantagh,New York,"New York, NY",3412,3412,3413,10237,206,294,335,835,83387413,141272565,223828932,448488910,491830,0.06037514654161782,0.08616647127784291,0.09815411661295048,0.08156686529256618,0.2467065868263473,0.3520958083832335,0.40119760479041916
City,Webster,Texas,"Houston, TX",435,435,435,1305,132,19,5,156,10393607,1794673,1986390,14174670,81181.5,0.30344827586206896,0.04367816091954023,0.011494252873563218,0.11954022988505747,0.8461538461538461,0.12179487179487179,0.03205128205128205
City,Wilton Manors,Florida,"Miami, FL",1571,1571,1571,4713,1533,1471,1502,4506,223653145,492527290,795256439,1511436874,334815.5,0.9758115849777212,0.936346276257161,0.9560789306174411,0.9560789306174411,0.3402130492676431,0.3264536173990235,0.3333333333333333
City,Woodmere,New York,"New York, NY",1145,1145,1145,3435,489,616,455,1560,311021284,455700703,488460127,1255182114,739141.5,0.42707423580786025,0.5379912663755458,0.39737991266375544,0.45414847161572053,0.31346153846153846,0.39487179487179486,0.2916666666666667
City,Corolla,North Carolina,"Virginia Beach, VA",427,427,429,1283,120,139,76,335,32348110,71704158,103266729,207318997,478573,0.2810304449648712,0.3255269320843091,0.17715617715617715,0.26110678098207324,0.3582089552238806,0.41492537313432837,0.22686567164179106
City,Brazoria,Texas,"Houston, TX",1905,1905,1905,5715,190,151,109,450,15999069,19268289,24869869,60137227,117032.5,0.09973753280839895,0.07926509186351706,0.05721784776902887,0.07874015748031496,0.4222222222222222,0.33555555555555555,0.24222222222222223
City,Beaumont,Texas,"Beaumont, TX",14967,14967,14969,44903,76,188,121,385,4677170,17581917,20716383,42975470,98060,0.005077837910068818,0.012560967461749182,0.008083372302759035,0.008574037369440795,0.1974025974025974,0.4883116883116883,0.3142857142857143
City,Frankford,Delaware,"Salisbury, MD",1174,1174,1174,3522,14,60,153,227,2006995,13096812,49191128,64294935,264468,0.01192504258943782,0.05110732538330494,0.1303236797274276,0.06445201590005678,0.06167400881057269,0.2643171806167401,0.6740088105726872
City,Hauula,Hawaii,"Honolulu, HI",454,454,456,1364,164,152,199,515,43830482,96177878,231356687,371365047,654988,0.36123348017621143,0.33480176211453744,0.43640350877192985,0.3775659824046921,0.31844660194174756,0.29514563106796116,0.3864077669902913
City,Easton,Maryland,"Easton, MD",3144,3144,3146,9434,6,26,226,258,1171114,7479696,294284975,302935785,888941,0.0019083969465648854,0.00826972010178117,0.07183725365543547,0.027347890608437567,0.023255813953488372,0.10077519379844961,0.875968992248062
City,Eastsound,Washington,NA,933,933,933,2799,65,57,30,152,19953032,27299400,27551446,74803878,410088,0.06966773847802786,0.06109324758842444,0.03215434083601286,0.054305108967488386,0.4276315789473684,0.375,0.19736842105263158
City,Gilchrist,Texas,"Houston, TX",129,129,131,389,127,119,112,358,18055385,27352036,48885899,94293320,217220,0.9844961240310077,0.9224806201550387,0.8549618320610687,0.9203084832904884,0.3547486033519553,0.3324022346368715,0.3128491620111732
City,Hoquiam,Washington,"Aberdeen, WA",1495,1495,1496,4486,1392,1069,345,2806,105723798,106357891,69045989,281127678,85754,0.9311036789297659,0.7150501672240802,0.2306149732620321,0.6255015604101649,0.49607982893799,0.3809693513898788,0.12295081967213115
City,Lake Arthur,Louisiana,NA,363,363,365,1091,49,48,105,202,2524601,4809376,24316062,31650039,126332,0.1349862258953168,0.1322314049586777,0.2876712328767123,0.1851512373968836,0.24257425742574257,0.2376237623762376,0.5198019801980198
City,Hatteras,North Carolina,"Kill Devil Hills, NC",86,86,88,260,86,86,83,255,16411860,26574784,67832962,110819606,295068,1,1,0.9431818181818182,0.9807692307692307,0.33725490196078434,0.33725490196078434,0.3254901960784314
City,Oldsmar,Florida,"Tampa, FL",3039,3039,3041,9119,64,350,382,796,9820921,77717085,187473119,275011125,282840.5,0.021059559065482066,0.11516946363935505,0.12561657349556066,0.08729027305625617,0.08040201005025126,0.4396984924623116,0.4798994974874372
City,Pawleys Island,South Carolina,"Georgetown, SC",3442,3442,3443,10327,408,468,1732,2608,67685015,144583047,1211181883,1423449945,494345.5,0.11853573503776874,0.13596746077861707,0.5030496659889632,0.2525418805074078,0.15644171779141106,0.1794478527607362,0.6641104294478528
City,Midway,Georgia,"Hinesville, GA",197,197,197,591,43,48,29,120,4577617,6946683,5281124,16805424,140849.5,0.2182741116751269,0.2436548223350254,0.14720812182741116,0.20304568527918782,0.35833333333333334,0.4,0.24166666666666667
City,Pocomoke City,Maryland,"Salisbury, MD",1420,1420,1420,4260,155,152,119,426,13571830,18824069,30168902,62564801,119658,0.10915492957746478,0.10704225352112676,0.08380281690140845,0.1,0.36384976525821594,0.3568075117370892,0.2793427230046948
City,Port Norris,New Jersey,"Vineland, NJ",171,171,173,515,65,61,55,181,6344491,7477956,8411802,22234249,120940,0.38011695906432746,0.3567251461988304,0.3179190751445087,0.35145631067961164,0.35911602209944754,0.3370165745856354,0.30386740331491713
City,Miramar Beach,Florida,"Crestview, FL",4068,4068,4069,12205,233,262,384,879,57917712,99326554,421667778,578912044,421483,0.05727630285152409,0.06440511307767945,0.09437208159252888,0.0720196640721016,0.26507394766780434,0.29806598407281,0.43686006825938567
City,Scotland,Maryland,"Mechanicsville, MD",88,88,89,265,59,67,73,199,10821096,18199691,32179736,61200523,276565,0.6704545454545454,0.7613636363636364,0.8202247191011236,0.7509433962264151,0.2964824120603015,0.33668341708542715,0.36683417085427134
City,Tierra Verde,Florida,"Tampa, FL",784,784,786,2354,627,491,437,1555,182814577,218880905,625408554,1027104036,405050,0.7997448979591837,0.6262755102040817,0.5559796437659033,0.6605777400169923,0.4032154340836013,0.3157556270096463,0.2810289389067524
City,Washington,North Carolina,"Washington, NC",459,459,461,1379,93,64,20,177,5443609,7072070,3854617,16370296,80477,0.20261437908496732,0.1394335511982571,0.04338394793926247,0.12835387962291517,0.5254237288135594,0.3615819209039548,0.11299435028248588
City,Saint James City,Florida,"Fort Myers, FL",1014,1014,1014,3042,790,785,762,2337,112399590,186358791,373954487,672712868,222871,0.7790927021696252,0.7741617357001972,0.7514792899408284,0.7682445759368837,0.3380402225074882,0.33590072742832694,0.32605905006418484
City,Westbrook,Connecticut,"Hartford, CT",1155,1155,1156,3466,44,137,327,508,10952094,45689664,238005269,294647027,474395.5,0.0380952380952381,0.11861471861471862,0.2828719723183391,0.1465666474321985,0.08661417322834646,0.26968503937007876,0.6437007874015748
City,Gulf Park Estates,Mississippi,"Gulfport, MS",678,678,680,2036,70,27,54,151,6483584,3479823,16244520,26207927,121782,0.10324483775811209,0.03982300884955752,0.07941176470588235,0.07416502946954813,0.46357615894039733,0.17880794701986755,0.3576158940397351
City,Hull,Massachusetts,"Boston, MA",1624,1618,1621,4863,827,871,472,2170,257568605,356715757,299915292,914199654,383445,0.5092364532019704,0.5383189122373301,0.2911782850092535,0.44622660908903966,0.3811059907834101,0.40138248847926267,0.21751152073732719
City,Severna Park,Maryland,"Baltimore, MD",3447,3447,3449,10343,3,22,96,121,1164198,10837278,107560320,119561796,890820,8.703220191470844e-4,0.006382361473745286,0.02783415482748623,0.011698733442908248,0.024793388429752067,0.18181818181818182,0.7933884297520661
City,Marion,Massachusetts,"Boston, MA",799,799,800,2398,33,39,81,153,10238758,19091551,125203900,154534209,642348,0.04130162703379224,0.04881101376720901,0.10125,0.06380316930775647,0.21568627450980393,0.2549019607843137,0.5294117647058824
City,Atlantic Beach,New York,"New York, NY",404,404,406,1214,92,33,62,187,49719970,30403337,133311858,213435165,783800,0.22772277227722773,0.08168316831683169,0.15270935960591134,0.15403624382207579,0.4919786096256685,0.17647058823529413,0.3315508021390374
City,Port Lavaca,Texas,"Port Lavaca, TX",1936,1936,1938,5810,2,41,59,102,183214,4833074,11686371,16702659,142754.5,0.0010330578512396695,0.021177685950413222,0.0304437564499484,0.01755593803786575,0.0196078431372549,0.4019607843137255,0.5784313725490197
City,Aiea,Hawaii,"Honolulu, HI",4209,4209,4211,12629,0,146,33,179,0,101725838,35306798,137032636,708881,0,0.03468757424566405,0.007836618380432201,0.014173727135956925,0,0.8156424581005587,0.18435754189944134
City,Babylon,New York,"New York, NY",1302,1302,1302,3906,301,344,894,1539,121205609,158628919,746814398,1026648926,524783,0.23118279569892472,0.2642089093701997,0.6866359447004609,0.39400921658986177,0.19558154645873943,0.2235217673814165,0.580896686159844
City,Barnstable,Massachusetts,"East Falmouth, MA",7847,7847,7847,23541,50,115,487,652,12871120,45383241,846154631,904408992,770863,0.006371861858034918,0.014655282273480312,0.0620619344972601,0.027696359542925108,0.07668711656441718,0.17638036809815952,0.7469325153374233
City,Barrington,Rhode Island,"Providence, RI",2016,2016,2018,6050,64,92,132,288,18706977,39581082,119090328,177378387,475195.5,0.031746031746031744,0.04563492063492063,0.06541129831516353,0.047603305785123964,0.2222222222222222,0.3194444444444444,0.4583333333333333
City,Bay Saint Louis,Mississippi,"Gulfport, MS",1665,1665,1667,4997,517,567,360,1444,38731760,69619485,86725988,195077233,109336,0.3105105105105105,0.34054054054054056,0.21595680863827235,0.2889733840304182,0.35803324099722994,0.3926592797783934,0.24930747922437674
City,Bremerton,Washington,"Bremerton, WA",8616,8616,8616,25848,81,13,479,573,11933978,3567191,275741997,291243166,489787,0.009401114206128134,0.0015088207985143919,0.05559424326833798,0.022168059424326834,0.14136125654450263,0.02268760907504363,0.8359511343804538
City,Burlington Township,New Jersey,"Philadelphia, PA",3259,3259,3259,9777,1615,367,62,2044,204364855,69304400,21527584,295196839,134172,0.49555078244860384,0.1126112304387849,0.019024240564590365,0.20906208448399305,0.7901174168297456,0.17954990215264188,0.030332681017612523
City,Cambridge,Maryland,"Cambridge, MD",3378,3378,3379,10135,51,381,1390,1822,4448218,51852101,476591413,532891732,246456.5,0.015097690941385435,0.1127886323268206,0.41136430896715004,0.17977306364084855,0.027991218441273325,0.20911086717892427,0.7628979143798024
City,Cameron,Louisiana,"Lake Charles, LA",49,49,50,148,49,48,47,144,4820088,7383275,12804372,25007735,152695.5,1,0.9795918367346939,0.94,0.972972972972973,0.3402777777777778,0.3333333333333333,0.3263888888888889
City,Chester,Maryland,"Baltimore, MD",987,987,989,2963,86,132,195,413,20738905,43834905,134538644,199112454,380540,0.08713272543059777,0.1337386018237082,0.19716885743174925,0.13938575767802902,0.20823244552058112,0.3196125907990315,0.4721549636803874
City,Coos Bay,Oregon,"Coos Bay, OR",2739,2739,2740,8218,161,102,116,379,19778200,18222067,32164408,70164675,172088,0.05878057685286601,0.03723986856516977,0.042335766423357665,0.04611827695302993,0.42480211081794195,0.2691292875989446,0.30606860158311344
City,Corpus Christi,Texas,"Corpus Christi, TX",30819,30819,30819,92457,783,621,2141,3545,60581086,86979173,726896584,874456843,197220,0.025406405139686557,0.020149907524578993,0.0694701320613907,0.038342148241885414,0.22087447108603667,0.17517630465444287,0.6039492242595205
City,Cortez,Florida,"Bradenton, FL",195,195,195,585,195,195,178,568,39643349,78686839,148778441,267108629,372533,1,1,0.9128205128205128,0.9709401709401709,0.34330985915492956,0.34330985915492956,0.31338028169014087
City,Covington,Louisiana,"New Orleans, LA",6543,6543,6544,19630,49,102,197,348,7515361,22428153,100381946,130325460,287273.5,0.007488919455907076,0.015589179275561669,0.030103911980440098,0.01772796739684157,0.14080459770114942,0.29310344827586204,0.5660919540229885
City,Dulac,Louisiana,"Houma, LA",139,139,140,418,134,128,136,398,12789528,14502591,18225002,45517121,113332.5,0.9640287769784173,0.920863309352518,0.9714285714285714,0.9521531100478469,0.33668341708542715,0.32160804020100503,0.3417085427135678
City,East Hampton,New York,"New York, NY",3953,3953,3953,11859,34,87,99,220,25807861,101997455,278932511,406737827,1437256.5,0.008601062484189223,0.02200860106248419,0.025044270174550975,0.01855131124040813,0.15454545454545454,0.39545454545454545,0.45
City,East Palatka,Florida,"Palatka, FL",670,670,671,2011,33,76,178,287,1719953,8621187,54406618,64747758,198992,0.049253731343283584,0.11343283582089553,0.26527570789865873,0.1427150671307807,0.11498257839721254,0.26480836236933797,0.6202090592334495
City,Elizabeth City,North Carolina,"Elizabeth City, NC",3990,3990,3992,11972,1688,926,1134,3748,127269390,122633934,307299854,557203178,119567,0.4230576441102757,0.23208020050125314,0.28406813627254507,0.31306381556966256,0.4503735325506937,0.24706510138740662,0.3025613660618997
City,Erath,Louisiana,"Lafayette, LA",570,570,572,1712,467,374,244,1085,36249823,47934591,40073381,124257795,118745,0.8192982456140351,0.656140350877193,0.42657342657342656,0.6337616822429907,0.4304147465437788,0.34470046082949307,0.22488479262672811
City,Fairhaven,Massachusetts,"Providence, RI",2038,2038,2038,6114,179,172,395,746,37208202,45950029,177408949,260567180,315984.5,0.08783120706575073,0.08439646712463199,0.19381746810598627,0.12201504743212299,0.23994638069705093,0.23056300268096513,0.5294906166219839
City,Fife,Washington,"Seattle, WA",816,816,816,2448,116,24,28,168,27040093,7339772,25035089,59414954,254430,0.14215686274509803,0.029411764705882353,0.03431372549019608,0.06862745098039216,0.6904761904761905,0.14285714285714285,0.16666666666666666
City,Forked River,New Jersey,"New York, NY",865,865,865,2595,424,428,625,1477,72105918,108528181,289873653,470507752,271988,0.49017341040462425,0.49479768786127165,0.7225433526011561,0.5691714836223507,0.2870683818551117,0.2897765741367637,0.4231550440081246
City,Fort Pierce,Florida,"Port Saint Lucie, FL",9532,9532,9533,28597,36,611,1795,2442,3406796,82949174,584025299,670381269,223587.5,0.0037767519932857744,0.0640998741082669,0.18829329696842548,0.08539357275238661,0.014742014742014743,0.2502047502047502,0.735053235053235
City,Freeland,Washington,"Oak Harbor, WA",1199,1199,1199,3597,93,83,370,546,24158291,32340105,501671352,558169748,959265.5,0.07756463719766472,0.06922435362802336,0.3085904920767306,0.1517931609674729,0.17032967032967034,0.152014652014652,0.6776556776556777
City,Hackensack,New Jersey,"New York, NY",2711,2711,2713,8135,105,158,136,399,23088073,49383056,63742665,136213794,321169,0.03873109553670232,0.058281077093323495,0.050129008477699966,0.04904732636754763,0.2631578947368421,0.39598997493734334,0.3408521303258145
City,Havre de Grace,Maryland,"Baltimore, MD",2638,2638,2639,7915,18,90,67,175,3244212,20100210,29147301,52491723,228113,0.006823351023502654,0.03411675511751327,0.025388404698749527,0.022109917877447885,0.10285714285714286,0.5142857142857142,0.38285714285714284
City,Hewlett Harbor,New York,"New York, NY",148,148,148,444,64,52,50,166,67952661,70908354,109406760,248267775,1304124,0.43243243243243246,0.35135135135135137,0.33783783783783783,0.3738738738738739,0.3855421686746988,0.3132530120481928,0.30120481927710846
City,Hialeah Gardens,Florida,"Miami, FL",1893,1891,1894,5678,1518,703,532,2753,211022534,152440117,229843667,593306318,165721,0.8019017432646592,0.37176097303014277,0.2808870116156283,0.4848538217682283,0.5513984743915729,0.2553577915001816,0.19324373410824555
City,Islamorada,Florida,"Key West, FL",969,969,971,2909,492,741,851,2084,191374516,622007266,1581059544,2394441326,951791,0.5077399380804953,0.7647058823529411,0.8764160659114315,0.7163973874183568,0.236084452975048,0.3555662188099808,0.4083493282149712
City,Jacksonville,North Carolina,"Jacksonville, NC",9460,9460,9460,28380,104,85,180,369,8948447,10824180,42192037,61964664,147044,0.010993657505285413,0.008985200845665961,0.019027484143763214,0.013002114164904863,0.28184281842818426,0.23035230352303523,0.4878048780487805
City,Juno Beach,Florida,"Miami, FL",1042,1042,1043,3127,168,128,77,373,46754054,51376787,105268063,203398904,337402,0.16122840690978887,0.12284069097888675,0.0738255033557047,0.1192836584585865,0.450402144772118,0.34316353887399464,0.2064343163538874
City,Key Colony Beach,Florida,"Key West, FL",426,422,424,1272,417,420,415,1252,152939419,245064218,521242342,919245979,566330.5,0.9788732394366197,0.995260663507109,0.9787735849056604,0.9842767295597484,0.3330670926517572,0.3354632587859425,0.3314696485623003
City,Larose,Louisiana,"Houma, LA",763,763,764,2290,226,308,367,901,18721492,38790174,78325203,135836869,135510,0.2961992136304063,0.4036697247706422,0.4803664921465969,0.39344978165938865,0.25083240843507215,0.341842397336293,0.40732519422863483
City,League City,Texas,"Houston, TX",8432,8432,8432,25296,94,18,43,155,11697464,4133263,40178768,56009495,159152,0.011148007590132828,0.0021347248576850096,0.0050996204933586335,0.006127450980392157,0.6064516129032258,0.11612903225806452,0.27741935483870966
City,Lighthouse Point,Florida,"Miami, FL",1748,1748,1749,5245,579,958,1233,2770,85320112,471543793,1748138080,2305001985,602983.5,0.33123569794050345,0.5480549199084668,0.7049742710120068,0.5281220209723546,0.20902527075812274,0.3458483754512635,0.4451263537906137
City,Lincoln City,Oregon,"Lincoln City, OR",2426,2426,2428,7280,305,124,54,483,52536210,30941007,22523965,106001182,188506,0.12572135201978565,0.051112943116240726,0.022240527182866558,0.06634615384615385,0.6314699792960663,0.2567287784679089,0.11180124223602485
City,Lynn,Massachusetts,"Boston, MA",6189,6189,6189,18567,354,76,142,572,81165031,25194502,77433738,183793271,269255.5,0.057198254968492485,0.012279851349167878,0.02294393278397156,0.030807346367210643,0.6188811188811189,0.13286713286713286,0.24825174825174826
City,Marysville,Washington,"Seattle, WA",8700,8700,8700,26100,47,24,174,245,11613652,7487432,109242772,128343856,435737,0.005402298850574713,0.002758620689655172,0.02,0.009386973180076629,0.19183673469387755,0.09795918367346938,0.710204081632653
City,Merritt Island,Florida,"Palm Bay, FL",5922,5920,5922,17764,1725,1503,2167,5395,184758635,397769195,1359236568,1941764398,287335,0.29128672745694023,0.2538851351351351,0.36592367443431273,0.30370412069353747,0.31974050046339203,0.27859128822984247,0.4016682113067655
City,Miami Gardens,Florida,"Miami, FL",9444,9444,9446,28334,5280,3055,2901,11236,673610372,639578337,833109926,2146298635,198982.5,0.5590851334180432,0.3234858110969928,0.3071141223798433,0.3965553751676431,0.4699181203275187,0.2718939124243503,0.25818796724813103
City,Miami Springs,Florida,"Miami, FL",1269,1269,1269,3807,1170,1128,991,3289,315084773,432710533,523193602,1270988908,375238,0.9219858156028369,0.8888888888888888,0.780929866036249,0.8639348568426582,0.3557312252964427,0.3429613864396473,0.30130738826391
City,Middleburg,Florida,"Jacksonville, FL",7201,7201,7203,21605,46,174,222,442,5189718,27542047,82871937,115603702,186063,0.006388001666435218,0.024163310651298432,0.030820491461890878,0.020458227262207824,0.10407239819004525,0.3936651583710407,0.502262443438914
City,Miramar,Florida,"Miami, FL",12779,12779,12780,38338,8895,9848,8216,26959,1557752360,2784941091,3880148913,8222842364,264516,0.6960638547617184,0.770639330151029,0.6428794992175274,0.7031926548072408,0.32994547275492414,0.3652954486442375,0.3047590786008383
City,Monmouth Beach,New Jersey,"New York, NY",681,681,683,2045,313,236,460,1009,99023373,155078658,596013832,850115863,767082,0.45961820851688695,0.3465491923641703,0.6734992679355783,0.49339853300733494,0.31020812685827553,0.23389494549058473,0.45589692765113976
City,Montegut,Louisiana,"Houma, LA",417,417,418,1252,408,375,402,1185,34263935,41871893,60427014,136562842,111190,0.9784172661870504,0.8992805755395683,0.9617224880382775,0.9464856230031949,0.34430379746835443,0.31645569620253167,0.3392405063291139
City,Morgan City,Louisiana,"Morgan City, LA",1548,1548,1548,4644,235,326,390,951,17125427,31884707,81316856,130326990,106672,0.15180878552971577,0.21059431524547803,0.25193798449612403,0.20478036175710596,0.24710830704521555,0.34279705573080965,0.41009463722397477
City,Newburyport,Massachusetts,"Boston, MA",2230,2230,2231,6691,53,60,109,222,18736624,31513759,99117638,149368021,591569.5,0.02376681614349776,0.026905829596412557,0.04885701479157328,0.03317889702585563,0.23873873873873874,0.2702702702702703,0.49099099099099097
City,Niceville,Florida,"Crestview, FL",4235,4235,4236,12706,36,65,352,453,6084796,18095717,211766585,235947098,473381,0.008500590318772138,0.015348288075560802,0.08309726156751653,0.035652447662521645,0.07947019867549669,0.1434878587196468,0.7770419426048565
City,North Bergen,New Jersey,"New York, NY",3467,3467,3468,10402,17,13,186,216,4806354,4764591,121955942,131526887,595128.5,0.00490337467551197,0.0037496394577444477,0.05363321799307959,0.020765237454335703,0.0787037037037037,0.06018518518518518,0.8611111111111112
City,North Miami Beach,Florida,"Miami, FL",4189,4189,4189,12567,2710,818,1465,4993,322653494,159582855,1112078576,1594314925,158708,0.6469324421102889,0.19527333492480306,0.3497254714729052,0.3973104161693324,0.542759863809333,0.16382936110554777,0.29341077508511915
City,Oak Island,North Carolina,"Conway, SC",2793,2793,2795,8381,77,262,1303,1642,11582541,63638306,572119399,647340246,373097.5,0.02756892230576441,0.09380594343000358,0.4661896243291592,0.1959193413673786,0.04689403166869671,0.15956151035322777,0.7935444579780755
City,Ocean Isle Beach,North Carolina,"Conway, SC",2354,2354,2356,7064,54,836,1409,2299,7953359,246117237,843023171,1097093767,432388,0.022939677145284623,0.35514018691588783,0.5980475382003395,0.3254530011325028,0.0234884732492388,0.36363636363636365,0.6128751631143976
City,Pahoa,Hawaii,"Hilo, HI",2007,2007,2009,6023,4,14,104,122,588703,2473318,45785859,48847880,308169.5,0.001993024414549078,0.006975585450921774,0.051767048282727726,0.02025568653494936,0.03278688524590164,0.11475409836065574,0.8524590163934426
City,Perry,Florida,NA,2334,2334,2334,7002,24,24,402,450,1127761,1984958,115464578,118577297,259027.5,0.010282776349614395,0.010282776349614395,0.17223650385604114,0.06426735218508997,0.05333333333333334,0.05333333333333334,0.8933333333333333
City,Port Bolivar,Texas,"Houston, TX",1264,1264,1264,3792,1084,938,801,2823,171668304,226256706,341471767,739396777,227882,0.8575949367088608,0.7420886075949367,0.6337025316455697,0.7444620253164557,0.3839886645412682,0.3322706340772228,0.28374070138150903
City,Port Mansfield,Texas,"Raymondville, TX",129,129,131,389,31,43,90,164,1666115,2914559,14416881,18997555,96532.5,0.24031007751937986,0.3333333333333333,0.6870229007633588,0.42159383033419023,0.18902439024390244,0.2621951219512195,0.5487804878048781
City,Port Salerno,Florida,"Port Saint Lucie, FL",1541,1541,1542,4624,46,177,156,379,5673373,37650147,74241341,117564861,240504,0.029850746268656716,0.11486048020765736,0.10116731517509728,0.08196366782006921,0.12137203166226913,0.46701846965699206,0.41160949868073876
City,Portland,Maine,"Portland, ME",5919,5919,5919,17757,7,58,199,264,1339281,16416355,103898505,121654141,489107,0.0011826322013853692,0.009798952525764487,0.03362054401081264,0.014867376245987498,0.026515151515151516,0.2196969696969697,0.7537878787878788
City,Quantico,Maryland,"Salisbury, MD",225,225,225,675,47,53,58,158,4276453,6963130,17530714,28770297,139103.5,0.2088888888888889,0.23555555555555555,0.2577777777777778,0.23407407407407407,0.2974683544303797,0.33544303797468356,0.3670886075949367
City,Richmond Heights,Florida,"Miami, FL",917,917,918,2752,4,96,54,154,772750,20999196,14963577,36735523,225684,0.004362050163576881,0.10468920392584515,0.058823529411764705,0.0559593023255814,0.025974025974025976,0.6233766233766234,0.35064935064935066
City,Rockport,Texas,"Corpus Christi, TX",4131,4131,4133,12395,519,1109,1745,3373,54706343,196597487,893480466,1144784296,239009,0.12563543936092955,0.26845800048414425,0.42221146866682796,0.27212585720048404,0.15386895938333828,0.32878742958790397,0.5173436110287578
City,Saint Marys,Georgia,"Saint Marys, GA",1692,1693,1693,5078,154,203,509,866,18349209,32921681,184259408,235530298,233793,0.09101654846335698,0.11990549320732427,0.3006497341996456,0.17053958251280033,0.17782909930715934,0.23441108545034642,0.5877598152424942
City,Selbyville,Delaware,"Salisbury, MD",1608,1608,1609,4825,463,484,781,1728,80227601,136978083,351786097,568991781,305993.5,0.2879353233830846,0.3009950248756219,0.4853946550652579,0.3581347150259067,0.2679398148148148,0.2800925925925926,0.4519675925925926
City,Sequim,Washington,"Port Angeles, WA",4292,4292,4293,12877,53,37,150,240,9145463,10248078,81498252,100891793,406518.5,0.012348555452003728,0.008620689655172414,0.03494060097833683,0.018637881494136834,0.22083333333333333,0.15416666666666667,0.625
City,Sewalls Point,Florida,"Port Saint Lucie, FL",304,304,305,913,61,67,79,207,29068510,57340936,148814419,235223865,977034,0.20065789473684212,0.22039473684210525,0.25901639344262295,0.2267250821467689,0.2946859903381642,0.32367149758454106,0.38164251207729466
City,Shoreacres,Texas,"Houston, TX",216,216,216,648,21,46,47,114,2830004,8445414,13403750,24679168,196918,0.09722222222222222,0.21296296296296297,0.2175925925925926,0.17592592592592593,0.18421052631578946,0.40350877192982454,0.41228070175438597
City,South Miami Heights,Florida,"Miami, FL",2984,2984,2986,8954,130,87,19,236,27344043,20038270,5686790,53069103,223586,0.0435656836461126,0.029155495978552277,0.006363027461486939,0.026356935447844537,0.5508474576271186,0.3686440677966102,0.08050847457627118
City,Suffolk,Virginia,"Virginia Beach, VA",9659,9657,9660,28976,20,74,347,441,3098514,16697765,169679105,189475384,334205,0.002070607723366808,0.007662835249042145,0.035921325051759836,0.015219491993373826,0.045351473922902494,0.16780045351473924,0.7868480725623582
City,Tampa,Florida,"Tampa, FL",37422,37422,37423,112267,1104,1540,5570,8214,110938780,313298028,4713607180,5137843988,405506,0.02950136283469617,0.0411522633744856,0.14883894930924832,0.07316486590004187,0.1344046749452155,0.18748478207937666,0.6781105429754078
City,Tappahannock,Virginia,NA,790,790,791,2371,0,53,140,193,0,10241491,48609330,58850821,265546,0,0.0670886075949367,0.17699115044247787,0.08140025305778152,0,0.27461139896373055,0.7253886010362695
City,Tarpon Springs,Florida,"Tampa, FL",5300,5300,5301,15901,520,920,1083,2523,68678679,207724965,589133486,865537130,257930,0.09811320754716982,0.17358490566037735,0.20430107526881722,0.1586692660838941,0.20610384462940942,0.364645263575109,0.4292508917954816
City,Tequesta,Florida,"Miami, FL",1399,1399,1401,4199,180,111,254,545,38602389,40794423,298903650,378300462,425195,0.12866333095067906,0.07934238741958542,0.1812990720913633,0.12979280781138366,0.3302752293577982,0.2036697247706422,0.46605504587155966
City,Theodore,Alabama,"Mobile, AL",2733,2733,2734,8200,86,46,260,392,5677001,4967903,107178271,117823175,191266.5,0.031467252103915114,0.016831320892791803,0.09509875640087784,0.04780487804878049,0.2193877551020408,0.11734693877551021,0.6632653061224489
City,Townsend,Georgia,"Brunswick, GA",372,372,374,1118,15,52,58,125,1401167,10012022,23691801,35104990,265893,0.04032258064516129,0.13978494623655913,0.15508021390374332,0.11180679785330948,0.12,0.416,0.464
City,Tuckerton,New Jersey,"New York, NY",527,527,528,1582,203,201,367,771,31252655,41661047,129703437,202617139,225410,0.38519924098671726,0.38140417457305503,0.6950757575757576,0.48735777496839444,0.26329442282749677,0.2607003891050584,0.47600518806744485
City,Village of Palmetto Bay,Florida,"Miami, FL",2691,2689,2692,8072,260,276,265,801,80045086,147218200,222797690,450060976,533462,0.0966183574879227,0.10264038676087765,0.09843982169390787,0.09923191278493558,0.32459425717852686,0.3445692883895131,0.33083645443196
City,Villas,New Jersey,"Upper Township, NJ",1909,1909,1910,5728,502,488,395,1385,69364331,79679380,119861907,268905618,156510,0.26296490309062337,0.25563122053431114,0.20680628272251309,0.24179469273743018,0.3624548736462094,0.3523465703971119,0.2851985559566787
City,Virginia Beach,Virginia,"Virginia Beach, VA",47270,47270,47272,141812,3175,2833,5795,11803,547384360,763060816,3256272526,4566717702,315187,0.06716733657711021,0.05993230378675693,0.12258842443729903,0.0832299100217189,0.2689994069304414,0.24002372278234346,0.4909768702872151
City,Waianae,Hawaii,"Honolulu, HI",3622,3622,3624,10868,55,202,157,414,17284097,77742427,106379692,201406216,406374.5,0.015184980673660961,0.05577029265599116,0.043322295805739514,0.038093485461906516,0.13285024154589373,0.48792270531400966,0.37922705314009664
City,West Babylon,New York,"New York, NY",3451,3452,3450,10353,4,13,139,156,1025308,4461907,65999495,71486710,387123,0.0011590843233845263,0.0037659327925840093,0.04028985507246377,0.015068096203998842,0.02564102564102564,0.08333333333333333,0.8910256410256411
City,Williamsburg,Virginia,"Virginia Beach, VA",10253,10253,10254,30760,8,30,92,130,1270351,9060133,52674396,63004880,416504,7.802594362625573e-4,0.0029259728859845897,0.008972108445484689,0.0042262678803641094,0.06153846153846154,0.23076923076923078,0.7076923076923077
City,Barnegat Light,New Jersey,"New York, NY",302,302,303,907,272,238,148,658,148726729,193377380,175361236,517465345,774187,0.9006622516556292,0.7880794701986755,0.4884488448844885,0.7254685777287762,0.4133738601823708,0.3617021276595745,0.22492401215805471
City,Clinton,Washington,"Oak Harbor, WA",1335,1335,1336,4006,99,161,421,681,25319104,66325640,370569775,462214519,637473,0.07415730337078652,0.12059925093632959,0.31511976047904194,0.16999500748876684,0.14537444933920704,0.23641703377386197,0.618208516886931
City,Cohasset,Massachusetts,"Boston, MA",904,904,906,2714,43,50,75,168,23465086,42662905,174006325,240134316,953130,0.04756637168141593,0.05530973451327434,0.08278145695364239,0.06190125276344879,0.25595238095238093,0.2976190476190476,0.44642857142857145
City,Kenmore,Washington,"Seattle, WA",2419,2419,2421,7259,133,0,10,143,43102154,0,19322482,62424636,325829,0.054981397271599834,0,0.004130524576621231,0.019699683151949303,0.9300699300699301,0,0.06993006993006994
City,Hernando Beach,Florida,"Tampa, FL",459,459,459,1377,365,373,360,1098,75409020,110633112,162919901,348962033,292287.5,0.7952069716775599,0.8126361655773421,0.7843137254901961,0.7973856209150327,0.3324225865209472,0.33970856102003644,0.32786885245901637
City,Kingston,Washington,"Bremerton, WA",1386,1386,1388,4160,5,16,101,122,1376718,6411376,90674281,98462375,744754.5,0.0036075036075036075,0.011544011544011544,0.07276657060518732,0.029326923076923077,0.040983606557377046,0.13114754098360656,0.8278688524590164
City,Engelhard,North Carolina,NA,67,67,69,203,50,63,59,172,4936252,7603220,11492067,24031539,120618,0.746268656716418,0.9402985074626866,0.855072463768116,0.8472906403940886,0.29069767441860467,0.36627906976744184,0.3430232558139535
City,Harkers Island,North Carolina,"Morehead City, NC",373,373,373,1119,77,121,251,449,11233548,27876696,127260741,166370985,327434,0.2064343163538874,0.32439678284182305,0.6729222520107239,0.40125111706881145,0.1714922048997773,0.26948775055679286,0.5590200445434298
City,Old Saybrook,Connecticut,"Hartford, CT",1733,1733,1733,5199,414,297,371,1082,115467024,113287448,347518270,576272742,372385.5,0.23889209463358338,0.1713791113675707,0.2140796306982112,0.20811694556645507,0.3826247689463956,0.2744916820702403,0.34288354898336415
City,Ramrod Key,Florida,"Key West, FL",171,171,172,514,171,167,170,508,73531711,87318878,133714901,294565490,527866,1,0.9766081871345029,0.9883720930232558,0.9883268482490273,0.33661417322834647,0.328740157480315,0.3346456692913386
City,Navarre,Florida,"Pensacola, FL",5093,5077,5087,15257,146,214,469,829,23202001,46658059,211065263,280925323,282769,0.028666797565285687,0.04215087650187118,0.09219579319834874,0.05433571475388346,0.17611580217129072,0.25814234016887816,0.5657418576598311
City,Neptune Beach,Florida,"Jacksonville, FL",761,761,761,2283,96,127,131,354,24006915,49607426,81858400,155472741,405477.5,0.12614980289093297,0.16688567674113008,0.1721419185282523,0.15505913272010513,0.2711864406779661,0.3587570621468927,0.3700564971751412
City,Richmond Hill,Georgia,"Savannah, GA",2878,2878,2879,8635,82,249,482,813,12960543,57671134,198744606,269376283,287889,0.02849200833912439,0.08651841556636553,0.16741924279263634,0.09415170816444701,0.1008610086100861,0.3062730627306273,0.5928659286592866
City,Ridgefield Park,New Jersey,"New York, NY",943,943,944,2830,112,54,59,225,33085606,18332491,24594153,76012250,325168,0.11876988335100742,0.05726405090137858,0.0625,0.07950530035335689,0.49777777777777776,0.24,0.26222222222222225
City,Point Pleasant Beach,New Jersey,"New York, NY",961,961,961,2883,525,629,634,1788,188441974,346848052,574204272,1109494298,553612.5,0.54630593132154,0.6545265348595213,0.659729448491155,0.6201873048907388,0.2936241610738255,0.3517897091722595,0.354586129753915
City,Seaford,Delaware,"Salisbury, MD",2736,2736,2738,8210,14,36,52,102,1702463,5892357,15351871,22946691,193938,0.005116959064327485,0.013157894736842105,0.018991964937910884,0.012423873325213155,0.13725490196078433,0.35294117647058826,0.5098039215686274
City,Wadmalaw Island,South Carolina,"Charleston, SC",350,350,352,1052,46,69,135,250,8368610,22716118,145102096,176186824,561642.5,0.13142857142857142,0.19714285714285715,0.3835227272727273,0.2376425855513308,0.184,0.276,0.54
City,Inwood,New York,"New York, NY",433,433,434,1300,110,82,79,271,40956833,39094203,50889290,130940326,464860,0.2540415704387991,0.18937644341801385,0.18202764976958524,0.20846153846153845,0.4059040590405904,0.3025830258302583,0.2915129151291513
City,Awendaw,South Carolina,"Charleston, SC",291,291,293,875,13,48,104,165,3006857,18053221,98595492,119655570,635644,0.044673539518900345,0.16494845360824742,0.35494880546075086,0.18857142857142858,0.07878787878787878,0.2909090909090909,0.6303030303030303
City,Shiloh,North Carolina,"Elizabeth City, NC",95,95,96,286,78,83,68,229,10596867,14915875,23421744,48934486,175803,0.8210526315789474,0.8736842105263158,0.7083333333333334,0.8006993006993007,0.3406113537117904,0.3624454148471616,0.29694323144104806
City,Lindenhurst,New York,"New York, NY",4232,4232,4234,12698,1686,607,994,3287,509435989,205790899,481620950,1196847838,328704,0.3983931947069943,0.14343100189035918,0.23476617855455834,0.2588596629390455,0.5129297231518102,0.18466686948585337,0.30240340736233645
City,Hastings,Florida,"Jacksonville, FL",660,660,662,1982,94,133,91,318,6758736,12939516,17254197,36952449,96016.5,0.14242424242424243,0.2015151515151515,0.13746223564954682,0.16044399596367306,0.29559748427672955,0.41823899371069184,0.2861635220125786
City,Saint Helena Island,South Carolina,"Bluffton, SC",1210,1210,1211,3631,418,404,506,1328,54977563,82405738,294509128,431892429,203458,0.34545454545454546,0.3338842975206612,0.41783649876135426,0.3657394657119251,0.3147590361445783,0.3042168674698795,0.3810240963855422
City,Elberta,Alabama,"Fairhope, AL",919,919,920,2758,43,37,337,417,3961568,6511046,170992752,181465366,427762,0.046789989118607184,0.04026115342763874,0.36630434782608695,0.15119651921682378,0.10311750599520383,0.08872901678657075,0.8081534772182254
City,Apalachicola,Florida,NA,490,490,492,1472,8,20,92,120,1000272,3334906,33633683,37968861,252193,0.0163265306122449,0.04081632653061224,0.18699186991869918,0.08152173913043478,0.06666666666666667,0.16666666666666666,0.7666666666666667
City,Arlington,Massachusetts,"Boston, MA",4179,4179,4181,12539,316,139,121,576,122607072,96268598,108910145,327785815,579993.5,0.07561617611868868,0.033261545824359896,0.028940444869648408,0.0459366775659941,0.5486111111111112,0.24131944444444445,0.21006944444444445
City,Asharoken,New York,"New York, NY",95,95,96,286,42,44,40,126,40171344,51194032,56681222,148046598,1157645,0.4421052631578947,0.4631578947368421,0.4166666666666667,0.4405594405594406,0.3333333333333333,0.3492063492063492,0.31746031746031744
City,Astoria,Oregon,"Astoria, OR",1895,1895,1896,5686,239,95,93,427,45978832,25308414,34420929,105708175,230138,0.12612137203166227,0.05013192612137203,0.0490506329113924,0.0750967288075976,0.5597189695550351,0.2224824355971897,0.21779859484777517
City,Avalon,New Jersey,"Upper Township, NJ",1837,1837,1838,5512,1720,1642,1441,4803,1110738319,2108682498,3670401031,6889821848,1169261,0.9363091997822537,0.8938486663037561,0.7840043525571273,0.8713715529753265,0.35810951488652926,0.3418696647928378,0.30002082032063293
City,Aventura,Florida,"Miami, FL",7953,7953,7953,23859,7094,5349,3576,16019,1365668601,1883176805,2944552036,6193397442,290231,0.8919904438576638,0.6725763862693324,0.44964164466239154,0.6714028249297959,0.44284911667394966,0.33391597477994883,0.2232349085461015
City,Bayville,New York,"New York, NY",787,787,787,2361,369,236,130,735,160155907,133085789,110504768,403746464,507659,0.46886912325285895,0.29987293519695046,0.16518424396442186,0.3113087674714104,0.5020408163265306,0.32108843537414966,0.17687074829931973
City,Beaufort,South Carolina,"Bluffton, SC",1672,1672,1674,5018,96,206,449,751,13136964,45776054,288025330,346938348,379451,0.05741626794258373,0.12320574162679426,0.2682198327359618,0.14966121960940615,0.1278295605858855,0.27430093209054596,0.5978695073235686
City,Belle Haven,Virginia,"Washington, DC",1045,1045,1047,3137,181,215,62,458,38116031,69980232,45692041,153788304,248578,0.17320574162679425,0.20574162679425836,0.05921680993314231,0.14599936244819892,0.3951965065502183,0.46943231441048033,0.13537117903930132
City,Bethany Beach,Delaware,"Salisbury, MD",1356,1356,1358,4070,377,261,155,793,126181933,120240682,112085919,358508534,404174,0.278023598820059,0.19247787610619468,0.11413843888070692,0.19484029484029483,0.47540983606557374,0.3291298865069357,0.19546027742749053
City,Boston,Massachusetts,"Boston, MA",37975,37975,37977,113927,3210,5433,12116,20759,1348636137,3303383814,19958708372,24610728323,772612,0.08452929558920343,0.1430678077682686,0.31903520551913,0.18221317159233544,0.15463172599836217,0.2617178091430223,0.5836504648586155
City,Bow,Washington,"Mount Vernon, WA",532,532,532,1596,141,78,94,313,37646697,31214690,65513670,134375057,352453,0.2650375939849624,0.14661654135338345,0.17669172932330826,0.19611528822055138,0.4504792332268371,0.24920127795527156,0.3003194888178914
City,Bradenton,Florida,"Bradenton, FL",31193,31193,31194,93580,1711,1761,2313,5785,145564031,361366128,1365946842,1872877001,230198,0.054852050139454364,0.056454973872343155,0.07414887478361223,0.06181876469331054,0.2957649092480553,0.30440795159896283,0.39982713915298185
City,Brigantine,New Jersey,"Egg Harbor Township, NJ",2848,2848,2848,8544,1299,1783,1775,4857,307962011,556745155,1043612089,1908319255,313747,0.45610955056179775,0.6260533707865169,0.6232443820224719,0.5684691011235955,0.26744904261890057,0.36709903232448016,0.36545192505661933
City,Cape Canaveral,Florida,"Palm Bay, FL",2251,2251,2253,6755,656,422,313,1391,61038830,85881523,124970687,271891040,160804,0.2914260328742781,0.1874722345624167,0.13892587660896583,0.20592153960029608,0.4716031631919482,0.3033788641265277,0.22501797268152407
City,Cathlamet,Washington,NA,361,361,362,1084,91,78,38,207,15299765,20399169,14406737,50105671,231604,0.2520775623268698,0.21606648199445982,0.10497237569060773,0.19095940959409594,0.4396135265700483,0.37681159420289856,0.18357487922705315
City,Cedar Point,North Carolina,"Morehead City, NC",359,359,360,1078,23,77,118,218,2665170,19113991,67492399,89271560,358021.5,0.06406685236768803,0.21448467966573817,0.3277777777777778,0.20222634508348794,0.10550458715596331,0.3532110091743119,0.5412844036697247
City,Chesapeake,Virginia,"Virginia Beach, VA",24522,24522,24523,73567,1423,1814,1459,4696,239211639,475945486,728489884,1443647009,258972.5,0.05802952450860452,0.07397439034336514,0.05949516780165559,0.06383296858645861,0.3030238500851789,0.3862862010221465,0.3106899488926746
City,Chincoteague,Virginia,NA,302,302,303,907,302,302,303,907,56163076,72380680,106426540,234970296,239753,1,1,1,1,0.33296582138919517,0.33296582138919517,0.3340683572216097
City,Delcambre,Louisiana,"Lafayette, LA",182,182,183,547,94,131,121,346,6321035,10073850,16652884,33047769,75399.5,0.5164835164835165,0.7197802197802198,0.6612021857923497,0.6325411334552102,0.27167630057803466,0.3786127167630058,0.34971098265895956
City,Doral,Florida,"Miami, FL",6082,6080,6081,18243,3041,1589,1289,5919,627814039,496066623,690793726,1814674388,257203,0.5,0.2613486842105263,0.2119717151784246,0.32445321493175466,0.5137692177732726,0.2684575097144788,0.21777327251224868
City,East Falmouth,Massachusetts,"East Falmouth, MA",3770,3770,3770,11310,8,34,333,375,2025116,13145552,339612596,354783264,790838,0.002122015915119363,0.009018567639257295,0.0883289124668435,0.033156498673740056,0.021333333333333333,0.09066666666666667,0.888
City,El Portal,Florida,"Miami, FL",252,252,252,756,121,85,65,271,42463117,34410313,37055498,113928928,388831,0.4801587301587302,0.3373015873015873,0.25793650793650796,0.3584656084656085,0.44649446494464945,0.31365313653136534,0.23985239852398524
City,Eureka,California,"Eureka, CA",4583,4583,4583,13749,193,137,36,366,40751722,36001125,13528599,90281446,239591,0.042112153611171724,0.029893083133318787,0.0078551167357626,0.026620117826751038,0.5273224043715847,0.3743169398907104,0.09836065573770492
City,Ferndale,Washington,"Bellingham, WA",2969,2969,2971,8909,228,88,456,772,46362830,27067840,241379592,314810262,417156.5,0.07679353317615359,0.02963960929605928,0.15348367553012454,0.08665394544842295,0.29533678756476683,0.11398963730569948,0.5906735751295337
City,Freeport,Florida,"Crestview, FL",1295,1295,1296,3886,104,150,229,483,9628156,27490588,89891778,127010522,228086,0.08030888030888031,0.11583011583011583,0.17669753086419754,0.1242923314462172,0.2153209109730849,0.3105590062111801,0.474120082815735
City,Freeport,Texas,"Houston, TX",1074,1074,1074,3222,4,20,114,138,309844,1925320,23546234,25781398,164294,0.0037243947858473,0.0186219739292365,0.10614525139664804,0.04283054003724395,0.028985507246376812,0.14492753623188406,0.8260869565217391
City,French Settlement,Louisiana,"Baton Rouge, LA",168,168,170,506,41,47,58,146,6303951,7959729,13480761,27744441,170958.5,0.24404761904761904,0.27976190476190477,0.3411764705882353,0.2885375494071146,0.2808219178082192,0.3219178082191781,0.3972602739726027
City,Gig Harbor,Washington,"Seattle, WA",6826,6826,6827,20479,51,59,320,430,14533080,26603985,319654172,360791237,745471.5,0.007471432757105186,0.008643422209200117,0.046872711293393876,0.02099711899995117,0.1186046511627907,0.1372093023255814,0.7441860465116279
City,Greenwich,Connecticut,"Bridgeport, CT",5671,5671,5672,17014,47,115,239,401,33898975,165135453,968943907,1167978335,2634637,0.008287779932992418,0.02027861047434315,0.04213681241184767,0.023568825672975198,0.1172069825436409,0.286783042394015,0.5960099750623441
City,Hayes,Virginia,"Virginia Beach, VA",1512,1512,1512,4536,441,369,520,1330,67488693,80329206,207742181,355560080,216781,0.2916666666666667,0.24404761904761904,0.3439153439153439,0.2932098765432099,0.33157894736842103,0.2774436090225564,0.39097744360902253
City,Hertford,North Carolina,"Elizabeth City, NC",925,925,927,2777,127,125,171,423,12602372,18783761,55314939,86701072,161790,0.1372972972972973,0.13513513513513514,0.18446601941747573,0.1523226503420958,0.30023640661938533,0.29550827423167847,0.40425531914893614
City,Holmes Beach,Florida,"Bradenton, FL",1233,1233,1233,3699,1023,1191,1136,3350,387636587,745048610,1290717032,2423402229,639338.5,0.829683698296837,0.9659367396593674,0.9213300892133008,0.9056501757231684,0.3053731343283582,0.3555223880597015,0.3391044776119403
City,Horseshoe Beach,Florida,NA,142,142,142,426,77,119,133,329,5770015,17144491,35461949,58376455,154949,0.5422535211267606,0.8380281690140845,0.9366197183098591,0.7723004694835681,0.23404255319148937,0.3617021276595745,0.40425531914893614
City,Hypoluxo,Florida,"Miami, FL",652,650,653,1955,148,585,575,1308,23413189,124512628,257927511,405853328,242892,0.22699386503067484,0.9,0.8805513016845329,0.6690537084398976,0.11314984709480122,0.44724770642201833,0.4396024464831804
City,Isle of Palms,South Carolina,"Charleston, SC",1493,1489,1492,4474,962,947,736,2645,500731726,758523825,1280340038,2539595589,767165,0.6443402545210984,0.6359973136333109,0.4932975871313673,0.5911935628073313,0.36370510396975425,0.35803402646502835,0.2782608695652174
City,Lake Charles,Louisiana,"Lake Charles, LA",9563,9563,9565,28691,307,375,371,1053,29666270,60499221,130867639,221033130,166853,0.03210289658057095,0.03921363588831957,0.03878724516466283,0.03670140462165836,0.29154795821462487,0.3561253561253561,0.352326685660019
City,Lake Park,Florida,"Miami, FL",791,791,792,2374,159,240,73,472,19980396,49490477,31349729,100820602,200162.5,0.20101137800252844,0.3034134007585335,0.09217171717171717,0.1988205560235889,0.336864406779661,0.5084745762711864,0.15466101694915255
City,Lakebay,Washington,"Seattle, WA",890,890,891,2671,13,23,92,128,2030605,6487529,48382393,56900527,393587,0.014606741573033709,0.025842696629213482,0.10325476992143659,0.04792212654436541,0.1015625,0.1796875,0.71875
City,Little Egg Harbor,New Jersey,"New York, NY",1695,1695,1696,5086,170,146,119,435,27372916,31290613,43334247,101997776,201752,0.10029498525073746,0.08613569321533923,0.07016509433962265,0.08552890287062524,0.39080459770114945,0.335632183908046,0.2735632183908046
City,Little Ferry,New Jersey,"New York, NY",738,738,740,2216,421,650,664,1735,107752883,218146665,305722706,631622254,345571,0.5704607046070461,0.8807588075880759,0.8972972972972973,0.782942238267148,0.2426512968299712,0.3746397694524496,0.38270893371757925
City,Logan Township,New Jersey,"Philadelphia, PA",156,156,158,470,45,27,33,105,6467354,4767678,8667174,19902206,169754,0.28846153846153844,0.17307692307692307,0.2088607594936709,0.22340425531914893,0.42857142857142855,0.2571428571428571,0.3142857142857143
City,Long Beach,California,"Los Angeles, CA",30428,30428,30430,91286,317,408,4357,5082,129652058,231235050,5786697483,6147584591,1060831,0.010418036019455764,0.013408702510845274,0.14318107131120605,0.055671187257629866,0.06237701692247147,0.08028335301062574,0.8573396300669028
City,Long Beach,New York,"New York, NY",3285,3285,3286,9856,2265,2002,1858,6125,972396791,1145013781,1593479838,3710890410,561438,0.6894977168949772,0.6094368340943683,0.5654290931223371,0.6214488636363636,0.36979591836734693,0.32685714285714285,0.3033469387755102
City,Luling,Louisiana,"New Orleans, LA",1214,1214,1214,3642,916,1154,1176,3246,149378315,258390517,384170217,791939049,233307.5,0.7545304777594728,0.9505766062602965,0.9686985172981878,0.8912685337726524,0.28219346888478125,0.3555144793592113,0.36229205175600737
City,Mandeville,Louisiana,"New Orleans, LA",5917,5917,5918,17752,190,275,402,867,32402340,69195556,263377586,364975482,295899,0.03211086699340882,0.04647625485888119,0.06792835417370734,0.0488395673726904,0.21914648212226068,0.31718569780853517,0.46366782006920415
City,Marathon,Florida,"Key West, FL",1703,1703,1704,5110,1611,1629,1529,4769,432763970,807791564,1846445036,3087000570,482298,0.9459776864357017,0.9565472695243687,0.8973004694835681,0.9332681017612524,0.33780666806458376,0.3415810442440763,0.3206122876913399
City,Mary Esther,Florida,"Crestview, FL",1584,1584,1584,4752,0,0,128,128,0,0,68184851,68184851,532357,0,0,0.08080808080808081,0.026936026936026935,0,0,1
City,Mc Clellanville,South Carolina,"Charleston, SC",333,333,334,1e3,33,75,178,286,6396094,20133202,113596306,140125602,394268,0.0990990990990991,0.22522522522522523,0.5329341317365269,0.286,0.11538461538461539,0.26223776223776224,0.6223776223776224
City,Medley,Florida,"Miami, FL",59,59,61,179,49,46,61,156,6716183,13494782,45319165,65530130,312742,0.8305084745762712,0.7796610169491526,1,0.8715083798882681,0.3141025641025641,0.2948717948717949,0.391025641025641
City,Merrick,New York,"New York, NY",3836,3836,3836,11508,333,482,1019,1834,146044557,264357150,854764216,1265165923,618663,0.08680917622523462,0.1256517205422315,0.26564129301355577,0.15936739659367397,0.18157033805888767,0.2628135223555071,0.5556161395856052
City,Narragansett,Rhode Island,"Providence, RI",2166,2166,2167,6499,67,71,210,348,19314704,31339846,198710986,249365536,613158.5,0.030932594644506,0.03277931671283472,0.09690816797415783,0.05354669949222957,0.1925287356321839,0.20402298850574713,0.603448275862069
City,Ocean View,Delaware,"Salisbury, MD",2307,2307,2308,6922,302,257,320,879,64823902,74440671,143518261,282782834,293257,0.13090593844820111,0.11140008669267447,0.1386481802426343,0.12698642010979486,0.3435722411831627,0.2923777019340159,0.3640500568828214
City,Okatie,South Carolina,"Bluffton, SC",3083,3083,3085,9251,228,86,350,664,48496394,24325687,236200570,309022651,346069,0.07395394096659098,0.027894907557573793,0.11345218800648298,0.07177602421359854,0.3433734939759036,0.12951807228915663,0.5271084337349398
City,Oriental,North Carolina,"New Bern, NC",437,437,437,1311,170,219,285,674,25421169,53256843,120042892,198720904,269027.5,0.3890160183066362,0.5011441647597255,0.6521739130434783,0.5141113653699466,0.2522255192878338,0.3249258160237389,0.4228486646884273
City,Panama City,Florida,"Panama City, FL",11317,11318,11318,33953,399,542,1067,2008,35316673,92063855,493746147,621126675,232816,0.035256693470000884,0.047888319491076164,0.0942746068209931,0.05914057667952758,0.19870517928286852,0.2699203187250996,0.5313745019920318
City,Paradis,Louisiana,"New Orleans, LA",76,76,77,229,75,75,73,223,10760924,12504008,17398802,40663734,166881,0.9868421052631579,0.9868421052631579,0.948051948051948,0.9737991266375546,0.336322869955157,0.336322869955157,0.3273542600896861
City,Pass Christian,Mississippi,"Gulfport, MS",1532,1532,1532,4596,119,182,243,544,12278753,26332752,70120272,108731777,162742,0.07767624020887728,0.11879895561357702,0.15861618798955612,0.11836379460400348,0.21875,0.33455882352941174,0.44669117647058826
City,Perryville,Maryland,"Philadelphia, PA",873,873,875,2621,12,42,66,120,1889857,8914755,24726562,35531174,259650,0.013745704467353952,0.048109965635738834,0.07542857142857143,0.045784051888592144,0.1,0.35,0.55
City,Placida,Florida,"Port Charlotte, FL",775,775,776,2326,277,463,582,1322,64435870,178700628,457871501,701007999,441156,0.3574193548387097,0.5974193548387097,0.75,0.5683576956147893,0.20953101361573373,0.3502269288956127,0.4402420574886536
City,Princess Anne,Maryland,"Salisbury, MD",1512,1508,1510,4530,287,223,237,747,21690416,25701219,59322969,106714604,110863,0.18981481481481483,0.14787798408488065,0.15695364238410597,0.16490066225165562,0.38420348058902276,0.29852744310575635,0.3172690763052209
City,Punta Gorda,Florida,"Port Charlotte, FL",11395,11395,11397,34187,2949,2261,2706,7916,366715957,517940088,1326307493,2210963538,221441,0.2587977182974989,0.19842035980693287,0.2374309028691761,0.23155000438763274,0.3725366346639717,0.28562405255179385,0.34183931278423446
City,Rockport,Massachusetts,"Boston, MA",1128,1128,1130,3386,70,28,58,156,24743623,14245725,54780226,93769574,459323.5,0.06205673758865248,0.024822695035460994,0.05132743362831858,0.04607206142941524,0.44871794871794873,0.1794871794871795,0.3717948717948718
City,Rye,New York,"New York, NY",1474,1474,1476,4424,52,22,43,117,54835351,43375448,237602514,335813313,1696388,0.035278154681139755,0.014925373134328358,0.029132791327913278,0.026446654611211574,0.4444444444444444,0.18803418803418803,0.36752136752136755
City,Sag Harbor,New York,"New York, NY",574,574,574,1722,61,37,75,173,63551811,65000291,267526230,396078332,1931809,0.10627177700348432,0.06445993031358885,0.13066202090592335,0.10046457607433217,0.35260115606936415,0.2138728323699422,0.43352601156069365
City,Saint Michaels,Maryland,"Easton, MD",704,704,704,2112,36,96,195,327,8117877,41459081,213351534,262928492,706708,0.05113636363636364,0.13636363636363635,0.27698863636363635,0.15482954545454544,0.11009174311926606,0.29357798165137616,0.5963302752293578
City,Saint Pete Beach,Florida,"Tampa, FL",2449,2449,2451,7349,2292,2054,1952,6298,509372292,806870395,1800240171,3116482858,371096,0.9358922008983258,0.8387096774193549,0.7964096287229702,0.8569873452170363,0.3639250555731978,0.3261352810416005,0.3099396633852016
City,Savannah,Georgia,"Savannah, GA",14640,14640,14641,43921,557,932,662,2151,35635901,121498680,216723481,373858062,131980,0.0380464480874317,0.06366120218579235,0.04521549074516768,0.04897429475649462,0.2589493258949326,0.43328684332868433,0.3077638307763831
City,Schriever,Louisiana,"Houma, LA",508,508,508,1524,307,131,117,555,33177129,18543933,29060107,80781169,121794,0.6043307086614174,0.2578740157480315,0.23031496062992127,0.3641732283464567,0.5531531531531532,0.23603603603603604,0.21081081081081082
City,Shady Side,Maryland,"Baltimore, MD",763,763,765,2291,397,385,396,1178,92810383,118370165,236839532,448020080,305012.5,0.5203145478374837,0.5045871559633027,0.5176470588235295,0.5141859450021824,0.3370118845500849,0.32682512733446517,0.3361629881154499
City,South Daytona,Florida,"Palm Coast, FL",1529,1529,1530,4588,637,790,968,2395,48366626,115419652,255615172,419401450,155902,0.41661216481360364,0.5166775670372793,0.6326797385620915,0.5220139494333043,0.2659707724425887,0.3298538622129436,0.40417536534446763
City,South Kingstown,Rhode Island,"Providence, RI",2954,2954,2954,8862,154,54,244,452,28444268,19175881,180901066,228521215,442815,0.052132701421800945,0.01828029790115098,0.08259986459038592,0.051004287971112616,0.3407079646017699,0.11946902654867257,0.5398230088495575
City,South Mills,North Carolina,"Elizabeth City, NC",311,311,311,933,91,82,73,246,15330097,18849770,21680576,55860443,226482.5,0.29260450160771706,0.26366559485530544,0.2347266881028939,0.26366559485530544,0.3699186991869919,0.3333333333333333,0.2967479674796748
City,South Padre Island,Texas,"Brownsville, TX",2356,2356,2357,7069,1089,905,693,2687,159436168,228773692,400839398,789049258,218599,0.46222410865874364,0.38412563667232597,0.29401781926177345,0.3801103409251662,0.4052847041310011,0.3368068477856345,0.25790844808336433
City,Stafford Township,New Jersey,"New York, NY",536,536,536,1608,168,93,83,344,30589796,32990933,49248019,112828748,268276.5,0.31343283582089554,0.17350746268656717,0.15485074626865672,0.21393034825870647,0.4883720930232558,0.2703488372093023,0.24127906976744187
City,Surfside Beach,South Carolina,"Conway, SC",1212,1212,1213,3637,93,139,208,440,13661721,35128230,114479083,163269034,291223.5,0.07673267326732673,0.11468646864686469,0.17147568013190437,0.12097882870497663,0.21136363636363636,0.3159090909090909,0.4727272727272727
City,Susan,Virginia,"Virginia Beach, VA",166,166,168,500,40,68,73,181,6481074,14780324,27634110,48895508,232450,0.24096385542168675,0.40963855421686746,0.43452380952380953,0.362,0.22099447513812154,0.3756906077348066,0.40331491712707185
City,Swansea,Massachusetts,"Providence, RI",2049,2049,2051,6149,66,38,57,161,14229182,10620812,24266006,49116e3,268886,0.032210834553440704,0.018545632015617375,0.02779132130667967,0.02618311920637502,0.40993788819875776,0.2360248447204969,0.35403726708074534
City,Tahuya,Washington,"Shelton, WA",478,478,478,1434,17,34,108,159,2340432,6878587,50230575,59449594,351286,0.03556485355648536,0.07112970711297072,0.22594142259414227,0.1108786610878661,0.1069182389937107,0.2138364779874214,0.6792452830188679
City,Tall Timbers,Maryland,"Mechanicsville, MD",154,154,155,463,83,74,89,246,18670575,23701133,51520550,93892258,332990.5,0.538961038961039,0.4805194805194805,0.5741935483870968,0.531317494600432,0.33739837398373984,0.3008130081300813,0.3617886178861789
City,Teaneck,New Jersey,"New York, NY",3728,3728,3728,11184,14,91,16,121,4216672,36202160,14029463,54448295,396531,0.0037553648068669528,0.024409871244635194,0.004291845493562232,0.010819027181688127,0.11570247933884298,0.7520661157024794,0.1322314049586777
City,Toddville,Maryland,"Cambridge, MD",81,81,83,245,81,81,83,245,5641783,6616688,12891479,25149950,81750,1,1,1,1,0.3306122448979592,0.3306122448979592,0.33877551020408164
City,University Place,Washington,"Seattle, WA",3063,3063,3065,9191,5,4,99,108,1431920,1408594,84043317,86883831,748528.5,0.001632386549134835,0.001305909239307868,0.03230016313213703,0.011750625612011751,0.046296296296296294,0.037037037037037035,0.9166666666666666
City,Virginia Gardens,Florida,"Miami, FL",197,197,198,592,140,129,109,378,29088556,37777896,36119736,102986188,290154.5,0.7106598984771574,0.6548223350253807,0.5505050505050505,0.6385135135135135,0.37037037037037035,0.3412698412698413,0.28835978835978837
City,Waterford,Connecticut,"Norwich, CT",2702,2702,2702,8106,8,27,78,113,1476975,6329346,40899042,48705363,374472,0.0029607698001480384,0.00999259807549963,0.028867505551443375,0.01394029114236368,0.07079646017699115,0.23893805309734514,0.6902654867256637
City,Weehawken,New Jersey,"New York, NY",1008,1040,978,3026,108,365,323,796,57032240,300112165,450781333,807925738,873506,0.10714285714285714,0.35096153846153844,0.33026584867075665,0.26305353602115006,0.135678391959799,0.4585427135678392,0.4057788944723618
City,Wellfleet,Massachusetts,"East Falmouth, MA",1237,1237,1239,3713,61,51,118,230,23702963,31009457,133447885,188160305,716216.5,0.04931285367825384,0.041228779304769606,0.09523809523809523,0.06194451925666577,0.26521739130434785,0.2217391304347826,0.5130434782608696
City,Wells,Maine,"Portland, ME",4201,4101,4153,12455,93,80,875,1048,9256442,13416555,699676384,722349381,569708.5,0.022137586288978814,0.01950743721043648,0.21069106669877197,0.08414291449217182,0.08874045801526717,0.07633587786259542,0.8349236641221374
City,Westhampton,New York,"New York, NY",579,579,579,1737,19,28,137,184,12068544,23116790,316439487,351624821,1535500.5,0.03281519861830743,0.04835924006908463,0.23661485319516407,0.10592976396085205,0.10326086956521739,0.15217391304347827,0.7445652173913043
City,Westport,Washington,"Aberdeen, WA",594,594,596,1784,128,105,57,290,12583224,15100642,13892430,41576296,130766.5,0.21548821548821548,0.17676767676767677,0.09563758389261745,0.1625560538116592,0.4413793103448276,0.3620689655172414,0.19655172413793104
City,Woolford,Maryland,"Cambridge, MD",90,90,91,271,90,90,91,271,18244004,28496509,54858319,101598832,320125,1,1,1,1,0.33210332103321033,0.33210332103321033,0.33579335793357934
City,Edgemere,Maryland,"Baltimore, MD",1106,1106,1107,3319,90,175,518,783,17636800,43443126,213167261,274247187,311833,0.081374321880651,0.15822784810126583,0.4679313459801265,0.23591443205784876,0.11494252873563218,0.22349936143039592,0.6615581098339719
City,Hollywood,South Carolina,"Charleston, SC",511,511,512,1534,21,42,138,201,3407418,11625434,102647057,117679909,512528,0.0410958904109589,0.0821917808219178,0.26953125,0.13102998696219034,0.1044776119402985,0.208955223880597,0.6865671641791045
City,Kaplan,Louisiana,"Lafayette, LA",950,950,950,2850,63,111,106,280,4744688,11229121,13965265,29939074,109531,0.06631578947368422,0.1168421052631579,0.11157894736842106,0.09824561403508772,0.225,0.3964285714285714,0.37857142857142856
City,Murrells Inlet,South Carolina,"Conway, SC",5550,5550,5550,16650,387,498,1443,2328,49806975,101416038,883668336,1034891349,340238.5,0.06972972972972973,0.08972972972972973,0.26,0.1398198198198198,0.16623711340206185,0.21391752577319587,0.6198453608247423
City,Palmyra,New Jersey,"Philadelphia, PA",935,935,937,2807,249,138,72,459,31157904,22102459,13463098,66723461,143888,0.2663101604278075,0.14759358288770053,0.0768409818569904,0.16351977199857498,0.5424836601307189,0.3006535947712418,0.1568627450980392
City,Rock Hall,Maryland,NA,664,664,666,1994,165,288,326,779,24785791,57928631,162873825,245588247,220973,0.24849397590361447,0.43373493975903615,0.4894894894894895,0.39067201604814444,0.21181001283697048,0.36970474967907574,0.4184852374839538
City,Piney Point,Maryland,"Mechanicsville, MD",172,172,174,518,122,159,165,446,24808078,49986752,86398581,161193411,333754,0.7093023255813954,0.9244186046511628,0.9482758620689655,0.861003861003861,0.273542600896861,0.35650224215246634,0.36995515695067266
City,Shelton,Washington,"Shelton, WA",4740,4740,4741,14221,8,27,206,241,1168984,5710807,87436723,94316514,373477,0.0016877637130801688,0.00569620253164557,0.043450748787175704,0.01694676886294916,0.03319502074688797,0.11203319502074689,0.8547717842323651
City,Tybee Island,Georgia,"Savannah, GA",795,795,797,2387,715,660,514,1889,225312422,282294487,406945784,914552693,401389,0.89937106918239,0.8301886792452831,0.644918444165621,0.7913699204021785,0.37850714663843305,0.3493912122816305,0.27210164107993645
City,West Wildwood,New Jersey,"Upper Township, NJ",303,303,304,910,303,303,304,910,50717451,69260938,189478013,309456402,229951.5,1,1,1,1,0.33296703296703295,0.33296703296703295,0.33406593406593404
City,Quogue,New York,"New York, NY",317,317,317,951,15,60,136,211,15684962,114611911,577759023,708055896,2773264,0.0473186119873817,0.1892744479495268,0.42902208201892744,0.22187171398527866,0.07109004739336493,0.2843601895734597,0.6445497630331753
City,Marion Station,Maryland,"Salisbury, MD",516,516,517,1549,389,381,426,1196,24851702,32917212,96551581,154320495,84434,0.7538759689922481,0.7383720930232558,0.8239845261121856,0.7721110393802453,0.32525083612040134,0.318561872909699,0.35618729096989965
City,Poquoson,Virginia,"Virginia Beach, VA",1407,1407,1407,4221,1123,1008,1e3,3131,225247834,311322862,502137904,1038708600,304365,0.7981520966595593,0.7164179104477612,0.7107320540156361,0.7417673537076522,0.35867135100606834,0.3219418716065155,0.31938677738741617
City,Sea Isle City,New Jersey,"Upper Township, NJ",2135,2133,2135,6403,1974,2027,1716,5717,870223987,1390943855,1737165273,3998333115,682608,0.9245901639344263,0.9503047351148617,0.8037470725995316,0.8928627205997188,0.3452859891551513,0.3545565856218296,0.3001574252230191
City,Edgartown,Massachusetts,"Edgartown, MA",1566,1566,1567,4699,0,17,135,152,0,17577917,480016082,497593999,2467427.5,0,0.010855683269476373,0.08615188257817485,0.032347307937859116,0,0.1118421052631579,0.8881578947368421
City,Hubert,North Carolina,"Jacksonville, NC",1741,1741,1741,5223,10,10,100,120,921688,1370334,42094969,44386991,313833,0.005743825387708214,0.005743825387708214,0.05743825387708214,0.022975301550832855,0.08333333333333333,0.08333333333333333,0.8333333333333334
City,Alva,Florida,"Fort Myers, FL",589,589,590,1768,6,38,97,141,845047,9025968,59575578,69446593,369560,0.010186757215619695,0.06451612903225806,0.16440677966101694,0.07975113122171945,0.0425531914893617,0.2695035460992908,0.6879432624113475
City,Barnegat Township,New Jersey,"New York, NY",2801,2801,2803,8405,109,168,264,541,16453696,41207493,121972855,179634044,273828,0.038914673330953234,0.05997857907890039,0.09418480199785943,0.0643664485425342,0.20147874306839186,0.31053604436229204,0.4879852125693161
City,Bayou Vista,Texas,"Houston, TX",364,364,364,1092,364,364,363,1091,73733604,89995546,115688585,279417735,245262,1,1,0.9972527472527473,0.9990842490842491,0.33363886342804766,0.33363886342804766,0.3327222731439047
City,Bellingham,Washington,"Bellingham, WA",12452,12452,12454,37358,164,37,94,295,32766120,12858965,68304047,113929132,276526,0.013170575008030838,0.0029714102152264697,0.007547775814999197,0.007896568338776166,0.5559322033898305,0.12542372881355932,0.31864406779661014
City,Biloxi,Mississippi,"Gulfport, MS",5807,5805,5807,17419,112,112,198,422,8264078,12725710,53112575,74102363,139687,0.019287067332529707,0.01929371231696813,0.0340967797485793,0.024226419427062402,0.26540284360189575,0.26540284360189575,0.46919431279620855
City,Biscayne Park,Florida,"Miami, FL",343,343,345,1031,164,146,165,475,60630521,62903425,95355948,218889894,432780,0.478134110787172,0.42565597667638483,0.4782608695652174,0.46071774975751695,0.3452631578947368,0.30736842105263157,0.3473684210526316
City,Bristol,Rhode Island,"Providence, RI",2419,2419,2420,7258,20,30,79,129,4933431,9881258,53425791,68240480,410603,0.00826787928896238,0.012401818933443571,0.03264462809917355,0.017773491319922844,0.15503875968992248,0.23255813953488372,0.6124031007751938
City,Brunswick,Georgia,"Brunswick, GA",8626,8626,8626,25878,1128,1034,1890,4052,66652389,120823855,474362028,661838272,136805.5,0.13076744725249245,0.11987015998145142,0.21910503130071876,0.15658087951155422,0.2783810463968411,0.255182625863771,0.466436327739388
City,Cedarhurst,New York,"New York, NY",555,555,555,1665,182,148,125,455,100226389,106147787,112719389,319093565,704893,0.3279279279279279,0.26666666666666666,0.22522522522522523,0.2732732732732733,0.4,0.3252747252747253,0.27472527472527475
City,Chelsea,Massachusetts,"Boston, MA",1712,1712,1712,5136,213,144,97,454,54793566,61153668,81321782,197269016,363450,0.1244158878504673,0.08411214953271028,0.0566588785046729,0.08839563862928349,0.46916299559471364,0.31718061674008813,0.21365638766519823
City,Clearwater,Florida,"Tampa, FL",18991,18991,18991,56973,624,1086,5199,6909,56842241,215936964,3518838944,3791618149,424170,0.03285766942235796,0.05718498236006529,0.27376125533147283,0.12126796903796536,0.09031697785497178,0.15718627876682587,0.7524967433782024
City,Cocoa Beach,Florida,"Palm Bay, FL",3303,3299,3303,9905,1402,1371,1894,4667,252423691,407399746,1105627003,1765450440,325219,0.4244626097487133,0.41558047893301,0.5734181047532546,0.4711761736496719,0.30040711377758733,0.2937647310906364,0.4058281551317763
City,Columbia,North Carolina,"Kill Devil Hills, NC",76,76,78,230,65,73,70,208,5798902,9314424,16952077,32065403,127069.5,0.8552631578947368,0.9605263157894737,0.8974358974358975,0.9043478260869565,0.3125,0.35096153846153844,0.33653846153846156
City,Coupeville,Washington,"Oak Harbor, WA",1477,1477,1478,4432,37,44,148,229,8958292,14865226,107600462,131423980,495426,0.025050778605280974,0.02979011509817197,0.10013531799729364,0.051669675090252706,0.1615720524017467,0.19213973799126638,0.6462882096069869
City,Dartmouth,Massachusetts,"Providence, RI",3616,3616,3618,10850,13,12,142,167,2748729,4173842,179581148,186503719,785864,0.003595132743362832,0.00331858407079646,0.03924820342730791,0.015391705069124424,0.07784431137724551,0.0718562874251497,0.8502994011976048
City,Dauphin Island,Alabama,"Mobile, AL",598,598,599,1795,485,500,540,1525,80394842,133299457,219947041,433641340,268228,0.8110367892976589,0.8361204013377926,0.9015025041736227,0.8495821727019499,0.3180327868852459,0.32786885245901637,0.3540983606557377
City,Des Allemands,Louisiana,"New Orleans, LA",400,400,402,1202,386,389,396,1171,50225186,71585150,107360609,229170945,184181,0.965,0.9725,0.9850746268656716,0.9742096505823628,0.3296327924850555,0.33219470538001705,0.3381725021349274
City,Eastham,Massachusetts,"East Falmouth, MA",1897,1895,1898,5690,14,14,113,141,4309238,6393994,110663676,121366908,681076,0.007380073800738007,0.007387862796833773,0.059536354056902004,0.02478031634446397,0.09929078014184398,0.09929078014184398,0.8014184397163121
City,Edgewater,Florida,"Palm Coast, FL",3274,3274,3276,9824,227,135,472,834,23554781,20950166,200237329,244742276,191363,0.0693341478313989,0.04123396456933415,0.14407814407814407,0.08489413680781759,0.27218225419664266,0.1618705035971223,0.565947242206235
City,Fort Walton Beach,Florida,"Crestview, FL",2865,2865,2866,8596,24,51,290,365,2808755,8734182,144046370,155589307,435863,0.008376963350785341,0.01780104712041885,0.10118632240055828,0.0424616100511866,0.06575342465753424,0.13972602739726028,0.7945205479452054
City,Fox Island,Washington,"Seattle, WA",521,521,521,1563,8,21,88,117,2940007,13148822,102148107,118236936,929889,0.015355086372360844,0.04030710172744722,0.1689059500959693,0.07485604606525911,0.06837606837606838,0.1794871794871795,0.7521367521367521
City,Frisco,North Carolina,"Kill Devil Hills, NC",95,95,96,286,94,87,94,275,16292083,22393692,46114208,84799983,260941,0.9894736842105263,0.9157894736842105,0.9791666666666666,0.9615384615384616,0.3418181818181818,0.31636363636363635,0.3418181818181818
City,Georgetown,South Carolina,"Georgetown, SC",3069,3069,3070,9208,132,168,936,1236,14073293,24814094,680253206,719140593,495028.5,0.043010752688172046,0.05474095796676442,0.304885993485342,0.13423110338835795,0.10679611650485436,0.13592233009708737,0.7572815533980582
City,Gibsonton,Florida,"Tampa, FL",1283,1283,1283,3849,211,38,127,376,19891311,6487424,43297352,69676087,125901.5,0.16445830085736554,0.029618082618862042,0.0989867498051442,0.0976877110937906,0.5611702127659575,0.10106382978723404,0.3377659574468085
City,Gloucester,North Carolina,"Morehead City, NC",99,99,99,297,79,83,98,260,7272981,13598449,38821649,59693079,173732.5,0.797979797979798,0.8383838383838383,0.98989898989899,0.8754208754208754,0.3038461538461538,0.3192307692307692,0.3769230769230769
City,Gloucester City,New Jersey,"Philadelphia, PA",1234,1234,1236,3704,84,47,57,188,5965519,5299347,9185016,20449882,100781.5,0.06807131280388978,0.03808752025931929,0.04611650485436893,0.05075593952483801,0.44680851063829785,0.25,0.30319148936170215
City,Golden Meadow,Louisiana,"Houma, LA",353,353,355,1061,10,4,133,147,726679,407912,55422409,56557e3,412495,0.028328611898016998,0.0113314447592068,0.37464788732394366,0.13854853911404336,0.06802721088435375,0.027210884353741496,0.9047619047619048
City,Gulf Stream,Florida,"Miami, FL",180,180,181,541,28,45,90,163,15202640,84349712,436821780,536374132,2827740,0.15555555555555556,0.25,0.4972375690607735,0.30129390018484287,0.17177914110429449,0.27607361963190186,0.5521472392638037
City,Jamaica Beach,Texas,"Houston, TX",393,393,395,1181,387,388,388,1163,72476467,111846550,196762248,381085265,283738,0.9847328244274809,0.9872773536895675,0.9822784810126582,0.9847586790855207,0.33276010318142735,0.3336199484092863,0.3336199484092863
City,Key Largo,Florida,"Key West, FL",3014,3014,3015,9043,1575,1896,2102,5573,442581140,1009419243,3507877e3,4959877383,568653,0.5225613802256138,0.6290643662906437,0.6971807628524046,0.6162777839212651,0.2826125964471559,0.3402117351516239,0.3771756684012202
City,Key West,Florida,"Key West, FL",2760,2761,2760,8281,2559,2280,2073,6912,1092016196,1527089442,2834181974,5453287612,629406,0.9271739130434783,0.8257877580586744,0.7510869565217392,0.8346818017147688,0.3702256944444444,0.3298611111111111,0.2999131944444444
City,Kilauea,Hawaii,"Kapaa, HI",863,863,863,2589,31,64,55,150,18570459,61117012,147729740,227417211,1058608,0.03592120509849363,0.07415990730011587,0.06373117033603708,0.05793742757821553,0.20666666666666667,0.4266666666666667,0.36666666666666664
City,Kingsland,Georgia,"Saint Marys, GA",1730,1730,1732,5192,27,52,171,250,2854128,8154822,45480719,56489669,215035,0.01560693641618497,0.03005780346820809,0.098729792147806,0.04815100154083205,0.108,0.208,0.684
City,Lacombe,Louisiana,"New Orleans, LA",1386,1386,1388,4160,172,156,236,564,18293209,23325671,71196661,112815541,158017.5,0.1240981240981241,0.11255411255411256,0.17002881844380405,0.13557692307692307,0.3049645390070922,0.2765957446808511,0.41843971631205673
City,Lauderhill,Florida,"Miami, FL",7666,7666,7668,23e3,92,366,94,552,5769088,46921589,19141743,71832420,127277,0.012001043569006,0.047743282024523874,0.012258737610850287,0.024,0.16666666666666666,0.6630434782608695,0.17028985507246377
City,Lawrence,New York,"New York, NY",721,721,723,2165,182,133,92,407,114071830,157394593,197928202,469394625,1045250,0.2524271844660194,0.18446601941747573,0.1272475795297372,0.1879907621247113,0.44717444717444715,0.32678132678132676,0.22604422604422605
City,Layton,Florida,"Key West, FL",136,136,137,409,136,136,136,408,26537803,37064825,80976252,144578880,260454,1,1,0.9927007299270073,0.9975550122249389,0.3333333333333333,0.3333333333333333,0.3333333333333333
City,Lynn Haven,Florida,"Panama City, FL",2407,2407,2409,7223,116,164,438,718,15109905,33422298,166603395,215135598,268084,0.04819277108433735,0.06813460739509763,0.18181818181818182,0.09940467949605428,0.1615598885793872,0.22841225626740946,0.6100278551532033
City,Madeira Beach,Florida,"Tampa, FL",1181,1182,1182,3545,1179,969,1048,3196,253326101,394437468,777575021,1425338590,379737.5,0.9983065198983911,0.8197969543147208,0.8866328257191202,0.9015514809590973,0.3688986232790989,0.30319148936170215,0.327909887359199
City,Medford,Massachusetts,"Boston, MA",4945,4945,4945,14835,909,570,495,1974,400507435,336166076,474679884,1211353395,520392.5,0.1838220424671385,0.11526794742163801,0.10010111223458039,0.13306370070778564,0.46048632218844987,0.2887537993920973,0.2507598784194529
City,Milford,Delaware,"Salisbury, MD",2782,2782,2783,8347,144,100,95,339,17972818,18303211,43184527,79460556,168997,0.05176132278936017,0.035945363048166784,0.03413582464965864,0.04061339403378459,0.4247787610619469,0.2949852507374631,0.28023598820059
City,Mystic Islands,New Jersey,"New York, NY",1738,1738,1739,5215,728,1179,1378,3285,91827751,197270892,391635772,680734415,185512,0.4188722669735328,0.6783659378596087,0.7924094307073031,0.6299137104506232,0.22161339421613394,0.3589041095890411,0.41948249619482497
City,Newport Beach,California,"Los Angeles, CA",8298,8298,8300,24896,993,2046,1474,4513,1124649933,3393485180,4585683740,9103818853,1690461,0.11966738973246566,0.24656543745480838,0.17759036144578313,0.18127410025706941,0.22003102149346332,0.45335696875692444,0.32661200974961224
City,Nokomis,Florida,"Bradenton, FL",3015,3015,3016,9046,524,313,578,1415,72945363,93533437,628556036,795034836,310228,0.17379767827529022,0.10381426202321725,0.1916445623342175,0.1564227282776918,0.37031802120141344,0.22120141342756183,0.40848056537102473
City,North Bay Village,Florida,"Miami, FL",1235,1235,1236,3706,968,1113,842,2923,158696910,295901812,588223902,1042822624,256720,0.7838056680161943,0.9012145748987854,0.6812297734627831,0.7887209929843497,0.3311666096476223,0.3807731782415327,0.28806021211084504
City,Ocean Springs,Mississippi,"Gulfport, MS",2210,2210,2210,6630,24,37,174,235,1936956,5390095,78484290,85811341,258994,0.01085972850678733,0.0167420814479638,0.07873303167420814,0.03544494720965309,0.10212765957446808,0.1574468085106383,0.7404255319148936
City,Palatka,Florida,"Palatka, FL",3127,3127,3128,9382,60,71,253,384,2925421,5963173,67481190,76369784,191627.5,0.019187719859290055,0.0227054685001599,0.08088235294117647,0.04092943935195054,0.15625,0.18489583333333334,0.6588541666666666
City,Palm Bay,Florida,"Palm Bay, FL",14244,14244,14245,42733,28,3,179,210,1983380,453139,66549494,68986013,327021.5,0.001965739960685201,2.1061499578770007e-4,0.012565812565812566,0.004914234900428241,0.13333333333333333,0.014285714285714285,0.8523809523809524
City,Palm Beach Gardens,Florida,"Miami, FL",10292,10292,10294,30878,75,416,289,780,17409405,151491127,351186925,520087457,382887,0.007287213369607462,0.04041974349008939,0.028074606566932194,0.025260703413433512,0.09615384615384616,0.5333333333333333,0.37051282051282053
City,Pascagoula,Mississippi,"Gulfport, MS",2506,2506,2507,7519,51,86,285,422,2893519,6882782,58126090,67902391,122409,0.020351157222665603,0.034317637669592976,0.11368169126445951,0.05612448463891475,0.12085308056872038,0.2037914691943128,0.6753554502369669
City,Pearlington,Mississippi,"Gulfport, MS",161,161,162,484,26,54,78,158,1358321,4420452,14342171,20120944,110285.5,0.16149068322981366,0.33540372670807456,0.48148148148148145,0.32644628099173556,0.16455696202531644,0.34177215189873417,0.4936708860759494
City,Pensacola,Florida,"Pensacola, FL",31508,31508,31510,94526,150,276,2235,2661,11496830,38379773,814967749,864844352,276722,0.0047606956963310906,0.008759680081249206,0.07092986353538559,0.028150984914203498,0.05636978579481398,0.10372040586245772,0.8399098083427283
City,Plaquemine,Louisiana,"Baton Rouge, LA",1457,1457,1459,4373,149,164,113,426,12980249,19625947,18351572,50957768,114803.5,0.10226492793411118,0.11256005490734386,0.0774503084304318,0.09741596158243769,0.34976525821596244,0.38497652582159625,0.2652582159624413
City,Ponte Vedra,Florida,"Jacksonville, FL",1326,1326,1326,3978,92,44,126,262,26671070,15636542,89220981,131528593,401925.5,0.0693815987933635,0.033182503770739065,0.09502262443438914,0.06586224233283057,0.3511450381679389,0.16793893129770993,0.48091603053435117
City,Port Aransas,Texas,"Corpus Christi, TX",1570,1570,1571,4711,1002,917,714,2633,168025803,276634019,430845028,875504850,278074,0.6382165605095541,0.5840764331210191,0.45448758752387014,0.5589046911483762,0.38055450056969237,0.3482719331560957,0.2711735662742119
City,Portsmouth,New Hampshire,"Boston, MA",3180,3180,3181,9541,4,18,117,139,1187858,7161297,93333903,101683058,695979,0.0012578616352201257,0.005660377358490566,0.03678088651367494,0.014568703490200188,0.02877697841726619,0.12949640287769784,0.841726618705036
City,Portsmouth,Virginia,"Virginia Beach, VA",9265,9265,9266,27796,429,329,654,1412,44452968,49610028,187217955,281280951,167666.5,0.04630329195898543,0.035509983810037775,0.07058061731059788,0.05079867606849906,0.3038243626062323,0.2330028328611898,0.4631728045325779
City,Princeton,Florida,"Miami, FL",2658,2658,2658,7974,799,389,827,2015,153744933,87090038,228889585,469724556,223301,0.30060195635816406,0.14635063957863054,0.3111361926260346,0.2526962628542764,0.3965260545905707,0.19305210918114143,0.4104218362282878
City,Revere,Massachusetts,"Boston, MA",3800,3800,3802,11402,1234,651,668,2553,361574930,273945052,434636356,1070156338,378559,0.32473684210526316,0.1713157894736842,0.17569700157811677,0.223908086300649,0.48335291813552683,0.25499412455934195,0.2616529573051312
City,Saco,Maine,"Portland, ME",2222,2222,2222,6666,5,22,201,228,811402,5058341,82250484,88120227,354622,0.0022502250225022503,0.009900990099009901,0.09045904590459046,0.034203420342034205,0.021929824561403508,0.09649122807017543,0.881578947368421
City,San Diego,California,"San Diego, CA",109824,109824,109826,329474,66,340,1293,1699,27454109,197231923,1654975496,1879661528,922592,6.009615384615385e-4,0.003095862470862471,0.011773168466483346,0.005156704322647614,0.03884638022366098,0.20011771630370806,0.761035903472631
City,Seaford,Virginia,"Virginia Beach, VA",324,324,325,973,168,127,67,362,36073078,37452677,27523168,101048923,263337.5,0.5185185185185185,0.39197530864197533,0.20615384615384616,0.3720452209660843,0.46408839779005523,0.35082872928176795,0.1850828729281768
City,Seal Beach,California,"Los Angeles, CA",1715,1715,1716,5146,291,290,336,917,163266568,264046888,424588389,851901845,914935,0.16967930029154518,0.16909620991253643,0.1958041958041958,0.17819665759813447,0.3173391494002181,0.31624863685932386,0.366412213740458
City,Somers Point,New Jersey,"Egg Harbor Township, NJ",1252,1252,1254,3758,200,331,456,987,30776678,62164885,158275648,251217211,204148,0.1597444089456869,0.26437699680511184,0.36363636363636365,0.2626397019691325,0.20263424518743667,0.3353596757852077,0.46200607902735563
City,Somerville,Massachusetts,"Boston, MA",4539,4540,4538,13617,379,241,114,734,178435988,187846507,135935028,502217523,660918,0.08349856796651245,0.05308370044052863,0.0251211987659762,0.05390320922376441,0.5163487738419619,0.32833787465940056,0.1553133514986376
City,Stafford,Virginia,"Washington, DC",8196,8196,8198,24590,15,65,44,124,3897418,21450085,23565857,48913360,344004,0.0018301610541727673,0.007930697901415325,0.005367162722615272,0.0050427002846685645,0.12096774193548387,0.5241935483870968,0.3548387096774194
City,Stone Harbor,New Jersey,"Upper Township, NJ",977,977,977,2931,856,837,588,2281,540613573,1140802546,1472651208,3154067327,1134754,0.8761514841351075,0.8567041965199591,0.601842374616172,0.7782326850904129,0.37527400263042526,0.3669443226654976,0.25778167470407715
City,Stuart,Florida,"Port Saint Lucie, FL",7128,7124,7127,21379,640,507,376,1523,72859367,105371964,204652318,382883649,167110,0.08978675645342311,0.07116788321167883,0.05275712080819419,0.07123813087609336,0.42022324359816154,0.3328956007879186,0.2468811556139199
City,Sulphur,Louisiana,"Lake Charles, LA",3143,3143,3143,9429,47,72,140,259,5012907,11683408,53074185,69770500,196184,0.014953865733375756,0.02290804963410754,0.044543429844097995,0.02746844840386043,0.18146718146718147,0.277992277992278,0.5405405405405406
City,Summerland Key,Florida,"Key West, FL",1277,1277,1277,3831,1275,1264,1214,3753,425803900,719531447,1368112066,2513447413,561555,0.9984338292873923,0.9898198903680501,0.9506656225528582,0.9796397807361003,0.33972821742605913,0.33679722888355984,0.32347455369038103
City,Sunrise,Florida,"Miami, FL",11694,11632,11665,34991,380,435,81,896,25415090,66036304,32500610,123952004,128433,0.03249529673336754,0.03739683631361761,0.006943849121303043,0.02560658455031294,0.42410714285714285,0.48549107142857145,0.09040178571428571
City,Surfside Beach,Texas,"Houston, TX",382,382,382,1146,365,375,358,1098,42995278,61715558,96031126,200741962,167811.5,0.9554973821989529,0.981675392670157,0.93717277486911,0.9581151832460733,0.3324225865209472,0.34153005464480873,0.32604735883424407
City,Tilghman,Maryland,"Easton, MD",269,269,271,809,77,102,118,297,14581385,32239357,71614322,118435064,351519,0.2862453531598513,0.379182156133829,0.4354243542435424,0.36711990111248455,0.25925925925925924,0.3434343434343434,0.39730639730639733
City,Union Beach,New Jersey,"New York, NY",708,708,709,2125,202,164,256,622,38115776,40235163,88878315,167229254,248837,0.2853107344632768,0.23163841807909605,0.3610719322990127,0.29270588235294115,0.3247588424437299,0.26366559485530544,0.4115755627009646
City,Wingate,Maryland,"Cambridge, MD",50,50,51,151,50,50,51,151,3532455,4279693,8766338,16578486,86951,1,1,1,1,0.33112582781456956,0.33112582781456956,0.33774834437086093
City,Yorktown,Virginia,"Virginia Beach, VA",4849,4849,4849,14547,155,179,218,552,31385829,55725064,108577289,195688182,333298.5,0.03196535368117138,0.0369148277995463,0.04495772324190555,0.03794596824087441,0.2807971014492754,0.3242753623188406,0.39492753623188404
City,Bishopville,Maryland,"Salisbury, MD",613,613,613,1839,34,176,251,461,5861549,44838106,138834452,189534107,358947,0.05546492659053834,0.28711256117455136,0.4094616639477977,0.25067971723762916,0.0737527114967462,0.38177874186550975,0.544468546637744
City,Beach Haven,New Jersey,"New York, NY",749,749,749,2247,622,670,543,1835,324319869,518435217,720624797,1563379883,744175,0.8304405874499332,0.8945260347129506,0.7249666221628839,0.8166444147752558,0.33896457765667576,0.3651226158038147,0.2959128065395095
City,Bellmore,New York,"New York, NY",3594,3594,3594,10782,508,430,929,1867,210191340,215558105,656869660,1082619105,535068,0.14134668892598776,0.1196438508625487,0.2584863661658319,0.17315896865145614,0.27209426888055704,0.2303160149973219,0.49758971612212105
City,Camden,North Carolina,"Elizabeth City, NC",413,413,413,1239,203,144,217,564,30209145,31610587,71189658,133009390,222926,0.4915254237288136,0.3486682808716707,0.5254237288135594,0.4552058111380145,0.3599290780141844,0.2553191489361702,0.38475177304964536
City,Edenton,North Carolina,NA,1198,1198,1198,3594,29,71,217,317,2514296,9882264,77550386,89946946,233136,0.024207011686143573,0.05926544240400668,0.18113522537562604,0.08820255982192543,0.0914826498422713,0.22397476340694006,0.6845425867507886
City,Gibbstown,New Jersey,"Philadelphia, PA",481,481,483,1445,142,190,200,532,20223193,31673328,43409721,95306242,168740,0.29521829521829523,0.39501039501039503,0.4140786749482402,0.3681660899653979,0.2669172932330827,0.35714285714285715,0.37593984962406013
City,Lavallette,New Jersey,"New York, NY",2201,2201,2203,6605,1806,1968,1702,5476,596812266,1118783535,1745639199,3461235e3,559313.5,0.8205361199454794,0.8941390277146751,0.7725828415796641,0.8290688872066616,0.3298027757487217,0.3593864134404675,0.3108108108108108
City,Harwich Port,Massachusetts,"East Falmouth, MA",727,727,729,2183,70,26,64,160,21258216,14043977,147024017,182326210,512070.5,0.09628610729023383,0.03576341127922971,0.0877914951989026,0.07329363261566652,0.4375,0.1625,0.4
City,Orange Beach,Alabama,"Fairhope, AL",2830,2834,2825,8489,545,434,830,1809,119015503,157188461,670660706,946864670,403097,0.19257950530035337,0.15314043754410728,0.2938053097345133,0.21309930498291907,0.30127142067440577,0.23991155334438916,0.4588170259812051
City,Osprey,Florida,"Bradenton, FL",1299,1299,1300,3898,104,37,109,250,25381925,17946595,264869458,308197978,496034.5,0.0800615858352579,0.02848344880677444,0.08384615384615385,0.06413545407901487,0.416,0.148,0.436
City,Napoleonville,Louisiana,NA,349,349,351,1049,52,51,6,109,4734685,5953580,1268773,11957038,105153,0.1489971346704871,0.14613180515759314,0.017094017094017096,0.10390848427073403,0.47706422018348627,0.46788990825688076,0.05504587155963303
City,Reedsport,Oregon,"Roseburg, OR",856,856,858,2570,313,67,35,415,30064534,9187149,8794638,48046321,99392,0.36565420560747663,0.07827102803738317,0.04079254079254079,0.1614785992217899,0.7542168674698795,0.1614457831325301,0.08433734939759036
City,Paulsboro,New Jersey,"Philadelphia, PA",671,671,671,2013,147,81,73,301,14776776,10183395,11530032,36490203,115484,0.21907600596125187,0.12071535022354694,0.10879284649776454,0.14952806756085443,0.4883720930232558,0.2691029900332226,0.2425249169435216
City,Pine Knoll Shores,North Carolina,"Morehead City, NC",576,584,570,1730,93,83,90,266,22006178,30077922,54027032,106111132,372364.5,0.16145833333333334,0.1421232876712329,0.15789473684210525,0.15375722543352602,0.34962406015037595,0.31203007518796994,0.3383458646616541
City,Waialua,Hawaii,"Honolulu, HI",709,709,710,2128,24,39,46,109,13542983,25754966,46015427,85313376,704643,0.03385049365303244,0.05500705218617771,0.0647887323943662,0.051221804511278196,0.22018348623853212,0.3577981651376147,0.42201834862385323
City,Theriot,Louisiana,"Houma, LA",146,146,146,438,143,141,135,419,16749297,20942934,26632588,64324819,149065,0.9794520547945206,0.9657534246575342,0.9246575342465754,0.95662100456621,0.3412887828162291,0.33651551312649164,0.3221957040572792
City,Ship Bottom,New Jersey,"New York, NY",611,611,612,1834,564,563,448,1575,245694829,342703084,443369634,1031767547,584005,0.9230769230769231,0.9214402618657938,0.7320261437908496,0.8587786259541985,0.3580952380952381,0.3574603174603175,0.28444444444444444
City,Warren,Rhode Island,"Providence, RI",1197,1197,1198,3592,218,54,51,323,42254750,14917578,22138148,79310476,221316,0.1821219715956558,0.045112781954887216,0.04257095158597663,0.08992204899777283,0.6749226006191951,0.16718266253869968,0.15789473684210525
City,South Palm Beach,Florida,"Miami, FL",664,662,664,1990,662,650,474,1786,123343523,179794825,222482832,525621180,256224,0.9969879518072289,0.9818731117824774,0.713855421686747,0.8974874371859296,0.3706606942889138,0.3639417693169093,0.26539753639417696
City,Gloucester,Virginia,"Virginia Beach, VA",2964,2964,2966,8894,99,86,361,546,15703117,18485788,162376049,196564954,332065.5,0.03340080971659919,0.029014844804318488,0.12171274443695212,0.06138970092196987,0.1813186813186813,0.1575091575091575,0.6611721611721612
City,Inglis,Florida,NA,525,525,527,1577,31,43,78,152,2053761,3615580,19752033,25421374,122306.5,0.05904761904761905,0.08190476190476191,0.14800759013282733,0.0963855421686747,0.20394736842105263,0.28289473684210525,0.5131578947368421
City,Rocky Point,North Carolina,"Wilmington, NC",1120,1120,1121,3361,34,41,79,154,3023091,5156335,19841273,28020699,175827.5,0.030357142857142857,0.03660714285714286,0.0704727921498662,0.045819696518893185,0.22077922077922077,0.2662337662337662,0.512987012987013
City,Barataria,Louisiana,"New Orleans, LA",132,132,134,398,131,128,130,389,13646450,18905044,29772273,62323767,148211,0.9924242424242424,0.9696969696969697,0.9701492537313433,0.9773869346733668,0.33676092544987146,0.32904884318766064,0.3341902313624679
City,Captiva,Florida,"Fort Myers, FL",323,323,325,971,323,285,250,858,150446239,284878863,687707276,1123032378,910875.5,1,0.8823529411764706,0.7692307692307693,0.8836251287332647,0.3764568764568765,0.3321678321678322,0.2913752913752914
City,Meggett,South Carolina,"Charleston, SC",201,201,203,605,62,93,128,283,13417081,39953453,116219439,169589973,500440,0.30845771144278605,0.4626865671641791,0.6305418719211823,0.4677685950413223,0.21908127208480566,0.3286219081272085,0.45229681978798586
City,Cape Charles,Virginia,NA,131,131,133,395,57,46,39,142,10210957,12997815,17162619,40371391,256791.5,0.4351145038167939,0.3511450381679389,0.2932330827067669,0.3594936708860759,0.4014084507042254,0.323943661971831,0.2746478873239437
City,North Redington Beach,Florida,"Tampa, FL",427,427,427,1281,401,349,376,1126,88874809,180779746,378232228,647886783,552445,0.9391100702576113,0.8173302107728337,0.8805620608899297,0.8790007806401249,0.3561278863232682,0.3099467140319716,0.3339253996447602
City,South Bethany,Delaware,"Salisbury, MD",417,417,418,1252,51,40,37,128,19695674,19318359,23413933,62427966,470070.5,0.1223021582733813,0.09592326139088729,0.08851674641148326,0.10223642172523961,0.3984375,0.3125,0.2890625
City,Beverly Beach,Florida,"Palm Coast, FL",125,125,127,377,125,124,50,299,17298e3,19375298,21619268,58292566,143370,1,0.992,0.3937007874015748,0.7931034482758621,0.4180602006688963,0.41471571906354515,0.16722408026755853
City,Big Coppitt Key,Florida,"Key West, FL",399,399,400,1198,397,396,396,1189,91092367,154535645,336001164,581629176,388182,0.9949874686716792,0.9924812030075187,0.99,0.9924874791318865,0.33389402859545836,0.3330529857022708,0.3330529857022708
City,Butler Beach,Florida,"Jacksonville, FL",1416,1417,1416,4249,617,611,568,1796,128855209,199227773,316780954,644863936,317502,0.4357344632768362,0.43119266055045874,0.4011299435028249,0.4226876912214639,0.3435412026726058,0.34020044543429845,0.31625835189309576
City,Callaway,Florida,"Panama City, FL",1537,1537,1537,4611,29,85,330,444,2805222,12517665,94475665,109798552,198279,0.018867924528301886,0.05530253741054001,0.21470396877033182,0.09629147690305791,0.06531531531531531,0.19144144144144143,0.7432432432432432
City,Coral Terrace,Florida,"Miami, FL",2227,2227,2229,6683,414,542,372,1328,125329437,189063461,181050806,495443704,345658,0.18590031432420295,0.24337674000898069,0.16689098250336473,0.19871315277569954,0.3117469879518072,0.40813253012048195,0.28012048192771083
City,Country Club,Florida,"Miami, FL",4025,4017,4022,12064,3124,1753,1166,6043,405343502,335221677,408304588,1148869767,153427,0.7761490683229814,0.43639531989046554,0.28990551964196914,0.5009118037135278,0.5169617739533344,0.2900877047823929,0.1929505212642727
City,Feather Sound,Florida,"Tampa, FL",563,561,562,1686,559,395,349,1303,65354152,80602607,204040208,349996967,156858,0.9928952042628775,0.7040998217468806,0.6209964412811388,0.772835112692764,0.42900997697620874,0.3031465848042978,0.26784343821949347
City,Fountainbleau,Florida,"Miami, FL",6159,6141,6150,18450,2691,3023,3520,9234,390401960,520375568,1037879961,1948657489,174949,0.4369215781782757,0.4922651034033545,0.5723577235772358,0.5004878048780488,0.29142300194931775,0.3273770846870262,0.38119991336365605
City,Glencoe,Florida,"Palm Coast, FL",353,353,355,1061,127,154,74,355,18426720,36151459,28481933,83060112,217074,0.3597733711048159,0.43626062322946174,0.2084507042253521,0.33459000942507067,0.35774647887323946,0.43380281690140843,0.2084507042253521
City,Glenvar Heights,Florida,"Miami, FL",2224,2176,2201,6601,370,23,38,431,46303038,6507376,32347274,85157688,124202,0.16636690647482014,0.010569852941176471,0.017264879600181735,0.06529313740342373,0.8584686774941995,0.05336426914153132,0.08816705336426914
City,Golden Glades,Florida,"Miami, FL",2422,2422,2423,7267,1200,696,1498,3394,127104942,147113081,519719054,793937077,227283.5,0.495458298926507,0.28736581337737405,0.6182418489475856,0.46704279620200906,0.3535651149086623,0.20506776664702417,0.4413671184443135
City,Harbor Bluffs,Florida,"Tampa, FL",440,440,440,1320,24,78,277,379,6544185,28535408,258390564,293470157,660320,0.05454545454545454,0.17727272727272728,0.6295454545454545,0.2871212121212121,0.0633245382585752,0.20580474934036938,0.7308707124010554
City,Indian Harbour Beach,Florida,"Palm Bay, FL",1406,1407,1406,4219,330,304,483,1117,64614222,87358468,363111819,515084509,308489,0.23470839260312945,0.21606254442075337,0.3435277382645804,0.2647546812040768,0.2954341987466428,0.2721575649059982,0.432408236347359
City,Ives Estates,Florida,"Miami, FL",2423,2423,2424,7270,1397,431,724,2552,149586700,69143898,277435528,496166126,126364,0.5765579859678085,0.17787866281469253,0.2986798679867987,0.35103163686382394,0.5474137931034483,0.1688871473354232,0.2836990595611285
City,Kendale Lakes,Florida,"Miami, FL",6269,6269,6269,18807,1,0,273,274,169050,0,292435999,292605049,860450.5,1.595150741745095e-4,0,0.04354761524964109,0.014569043441271867,0.0036496350364963502,0,0.9963503649635036
City,Lauderdale-by-the-Sea,Florida,"Miami, FL",1940,1940,1941,5821,332,509,614,1455,67641961,216708440,542371154,826721555,479738,0.1711340206185567,0.26237113402061857,0.31633178773827925,0.24995705205291188,0.2281786941580756,0.34982817869415805,0.4219931271477663
City,Norland,Florida,"Miami, FL",278,278,280,836,275,202,92,569,17140052,23725991,25969432,66835475,77210,0.9892086330935251,0.7266187050359713,0.32857142857142857,0.680622009569378,0.4833040421792619,0.35500878734622143,0.1616871704745167
City,North River Shores,Florida,"Port Saint Lucie, FL",564,564,564,1692,2,41,150,193,269259,9606341,124273138,134148738,613877,0.0035460992907801418,0.0726950354609929,0.26595744680851063,0.1140661938534279,0.010362694300518135,0.21243523316062177,0.7772020725388601
City,Ocean City,Florida,"Crestview, FL",688,688,689,2065,51,20,89,160,4067943,3341175,41405343,48814461,242299,0.07412790697674419,0.029069767441860465,0.12917271407837447,0.0774818401937046,0.31875,0.125,0.55625
City,Opa-locka,Florida,"Miami, FL",950,950,952,2852,534,372,277,1183,55889459,49720666,52466134,158076259,120470,0.5621052631578948,0.391578947368421,0.29096638655462187,0.41479663394109395,0.4513947590870668,0.3144547759932375,0.23415046491969568
City,Parker,Florida,"Panama City, FL",571,569,570,1710,19,20,72,111,1739401,2633206,23061819,27434426,209094,0.03327495621716287,0.0351493848857645,0.12631578947368421,0.06491228070175438,0.17117117117117117,0.18018018018018017,0.6486486486486487
City,Pinewood,Florida,"Miami, FL",964,964,965,2893,106,286,359,751,14993341,52451709,95389692,162834742,197993,0.10995850622406639,0.2966804979253112,0.37202072538860104,0.2595921189077083,0.1411451398135819,0.3808255659121172,0.4780292942743009
City,Plantation Island,Florida,"Naples, FL",38,38,38,114,38,38,38,114,7171082,8877147,11061502,27109731,234728.5,1,1,1,1,0.3333333333333333,0.3333333333333333,0.3333333333333333
City,Saint Augustine Beach,Florida,"Jacksonville, FL",1252,1250,1251,3753,324,328,256,908,69058047,108351798,116297770,293707615,304199,0.25878594249201275,0.2624,0.20463629096722621,0.24193978150812684,0.3568281938325991,0.36123348017621143,0.28193832599118945
City,Saint Lucie,Florida,"Port Saint Lucie, FL",90,90,91,271,22,65,85,172,3436823,19313308,56524748,79274879,387599,0.24444444444444444,0.7222222222222222,0.9340659340659341,0.6346863468634686,0.12790697674418605,0.37790697674418605,0.4941860465116279
City,Suwannee,Florida,NA,215,215,215,645,208,212,212,632,18017460,29062021,54332733,101412214,137896,0.9674418604651163,0.986046511627907,0.986046511627907,0.9798449612403101,0.3291139240506329,0.33544303797468356,0.33544303797468356
City,Tamiami,Florida,"Miami, FL",5133,5133,5135,15401,602,525,597,1724,100755607,169068831,356433368,626257806,324406.5,0.11728034287940775,0.10227936879018118,0.11626095423563779,0.11194078306603468,0.3491879350348028,0.30452436194895594,0.3462877030162413
City,Town 'n' Country,Florida,"Tampa, FL",7522,7522,7523,22567,862,672,1537,3071,93140498,121524941,682108705,896774144,220965,0.11459718160063813,0.08933794203669237,0.20430679250299083,0.13608366198431338,0.28069032888309997,0.21882123086942365,0.5004884402474764
City,Villano Beach,Florida,"Jacksonville, FL",475,475,475,1425,266,357,279,902,67111255,136411836,210512355,414035446,375730.5,0.56,0.751578947368421,0.5873684210526315,0.6329824561403509,0.29490022172949004,0.39578713968957874,0.3093126385809313
City,Washington Park,Florida,"Miami, FL",184,184,185,553,154,140,131,425,21656145,25117711,28430979,75204835,178190,0.8369565217391305,0.7608695652173914,0.7081081081081081,0.7685352622061483,0.3623529411764706,0.32941176470588235,0.30823529411764705
City,Weeki Wachee Gardens,Florida,"Tampa, FL",311,311,311,933,300,307,308,915,30353825,45878880,77685903,153918608,149003,0.9646302250803859,0.9871382636655949,0.9903536977491961,0.9807073954983923,0.32786885245901637,0.3355191256830601,0.3366120218579235
City,West Little River,Florida,"Miami, FL",2729,2729,2729,8187,675,274,237,1186,75962263,46975378,65037869,187975510,137309,0.24734334921216564,0.10040307805056797,0.08684499816782704,0.14486380847685354,0.5691399662731872,0.23102866779089376,0.19983136593591905
City,West Park,Florida,"Miami, FL",1359,1359,1360,4078,154,158,62,374,23284461,27721792,12782949,63789202,170927,0.11331861662987491,0.11626195732155997,0.045588235294117645,0.09171162334477685,0.4117647058823529,0.42245989304812837,0.1657754010695187
City,Westview,Florida,"Miami, FL",766,766,766,2298,103,161,295,559,14318558,29668868,80390965,124378391,200710,0.13446475195822455,0.21018276762402088,0.38511749347258484,0.2432550043516101,0.18425760286225404,0.2880143112701252,0.5277280858676208
City,Isle of Hope,Georgia,"Savannah, GA",328,328,329,985,67,90,143,300,14872444,26775892,89294432,130942768,343190,0.20426829268292682,0.27439024390243905,0.43465045592705165,0.30456852791878175,0.22333333333333333,0.3,0.4766666666666667
City,Montgomery,Georgia,"Savannah, GA",435,435,437,1307,12,108,280,400,1549412,26648215,158463061,186660688,386943,0.027586206896551724,0.2482758620689655,0.6407322654462243,0.306044376434583,0.03,0.27,0.7
City,Skidaway Island,Georgia,"Savannah, GA",1390,1390,1392,4172,278,480,599,1357,97107597,233034430,510899104,841041131,540326,0.2,0.34532374100719426,0.430316091954023,0.3252636625119847,0.20486366985998525,0.3537214443625645,0.44141488577745025
City,Whitemarsh Island,Georgia,"Savannah, GA",693,693,695,2081,238,145,289,672,39056894,38029773,221854846,298941513,298211.5,0.3434343434343434,0.20923520923520925,0.4158273381294964,0.3229216722729457,0.3541666666666667,0.21577380952380953,0.43005952380952384
City,Puako,Hawaii,"Hilo, HI",440,440,441,1321,9,34,61,104,5133746,35186658,207815255,248135659,1728636.5,0.020454545454545454,0.07727272727272727,0.1383219954648526,0.07872823618470856,0.08653846153846154,0.3269230769230769,0.5865384615384616
City,Eden Isle,Louisiana,"New Orleans, LA",1169,1169,1171,3509,800,551,513,1864,120300108,151596127,225873184,497769419,257530,0.6843455945252352,0.4713430282292558,0.4380871050384287,0.5312054716443431,0.4291845493562232,0.2956008583690987,0.2752145922746781
City,Jean Lafitte,Louisiana,"New Orleans, LA",188,188,189,565,186,187,182,555,17750949,23179800,37723388,78654137,123142,0.9893617021276596,0.9946808510638298,0.9629629629629629,0.9823008849557522,0.33513513513513515,0.33693693693693694,0.3279279279279279
City,Fairfield,North Carolina,NA,38,38,39,115,38,38,39,115,3454365,4532857,9047998,17035220,114026,1,1,1,1,0.33043478260869563,0.33043478260869563,0.3391304347826087
City,Fairfield Harbour,North Carolina,"New Bern, NC",490,490,490,1470,138,167,228,533,19302245,31523103,68204271,119029619,206685,0.2816326530612245,0.3408163265306122,0.46530612244897956,0.3625850340136054,0.2589118198874296,0.3133208255159475,0.4277673545966229
City,Mesic,North Carolina,"New Bern, NC",43,43,43,129,43,42,42,127,2135609,3921923,9914436,15971968,87687,1,0.9767441860465116,0.9767441860465116,0.9844961240310077,0.33858267716535434,0.33070866141732286,0.33070866141732286
City,Myrtle Grove,North Carolina,"Wilmington, NC",1453,1453,1455,4361,32,51,252,335,5352037,11903643,190170162,207425842,530921,0.02202339986235375,0.03509979353062629,0.1731958762886598,0.07681724375143316,0.0955223880597015,0.15223880597014924,0.7522388059701492
City,River Bend,North Carolina,"New Bern, NC",506,506,507,1519,100,112,137,349,9313550,16928412,33590284,59832246,154087,0.1976284584980237,0.22134387351778656,0.2702169625246548,0.22975641869651087,0.28653295128939826,0.3209169054441261,0.39255014326647564
City,Saint James,North Carolina,"Conway, SC",1041,1041,1042,3124,8,70,105,183,2155232,26871552,66635728,95662512,465033,0.007684918347742555,0.06724303554274735,0.10076775431861804,0.05857874519846351,0.04371584699453552,0.3825136612021858,0.5737704918032787
City,Sea Breeze,North Carolina,"Wilmington, NC",380,380,382,1142,61,36,122,219,10204523,8495896,89724878,108425297,349020,0.16052631578947368,0.09473684210526316,0.3193717277486911,0.19176882661996497,0.2785388127853881,0.1643835616438356,0.5570776255707762
City,Diamond Beach,New Jersey,"Upper Township, NJ",437,438,438,1313,314,348,163,825,96126293,147120429,87639507,330886229,422409,0.7185354691075515,0.7945205479452054,0.3721461187214612,0.6283320639756284,0.3806060606060606,0.4218181818181818,0.19757575757575757
City,Ortley Beach,New Jersey,"New York, NY",767,763,766,2296,746,724,730,2200,174555185,256823670,447937059,879315914,348092,0.9726205997392438,0.9488859764089121,0.9530026109660574,0.9581881533101045,0.3390909090909091,0.3290909090909091,0.33181818181818185
City,Noyack,New York,"New York, NY",746,746,747,2239,31,66,106,203,19069164,71180479,238538216,328787859,1395087,0.04155495978552279,0.08847184986595175,0.14190093708165996,0.09066547565877624,0.15270935960591134,0.3251231527093596,0.5221674876847291
City,Shell Point,South Carolina,"Bluffton, SC",360,360,360,1080,87,40,76,203,13088894,7489320,24421228,44999442,177553,0.24166666666666667,0.1111111111111111,0.2111111111111111,0.18796296296296297,0.42857142857142855,0.19704433497536947,0.37438423645320196
City,Socastee,South Carolina,"Conway, SC",2433,2433,2434,7300,162,177,211,550,16279425,26242392,64517631,107039448,154921,0.06658446362515413,0.07274969173859433,0.08668857847165161,0.07534246575342465,0.29454545454545455,0.32181818181818184,0.3836363636363636
City,Port O Connor,Texas,"Port Lavaca, TX",311,311,312,934,58,88,152,298,7413077,15294292,60129791,82837160,214615.5,0.1864951768488746,0.2829581993569132,0.48717948717948717,0.31905781584582443,0.19463087248322147,0.2953020134228188,0.5100671140939598
City,Point Pleasant,New Jersey,"New York, NY",2555,2555,2555,7665,375,499,1214,2088,105585155,182050825,852541929,1140177909,472166.5,0.14677103718199608,0.19530332681017612,0.475146771037182,0.27240704500978474,0.17959770114942528,0.2389846743295019,0.5814176245210728
City,Lower Township,New Jersey,"Upper Township, NJ",1297,1297,1299,3893,73,74,196,343,13154194,19856112,114969728,147980034,337902,0.05628373168851195,0.05705474171164225,0.15088529638183218,0.08810685846390959,0.21282798833819241,0.21574344023323616,0.5714285714285714
City,Lower Alloways Creek Township,New Jersey,"Philadelphia, PA",170,170,171,511,88,46,37,171,9583990,8248043,9482671,27314704,149406,0.5176470588235295,0.27058823529411763,0.21637426900584794,0.33463796477495106,0.5146198830409356,0.26900584795321636,0.21637426900584794
City,Woodbridge Township,New Jersey,"New York, NY",6570,6570,6571,19711,81,82,34,197,19057702,21969102,18300630,59327434,259765,0.012328767123287671,0.012480974124809741,0.005174250494597474,0.009994419359748364,0.41116751269035534,0.41624365482233505,0.17258883248730963
City,Bristol Township,Pennsylvania,"Philadelphia, PA",1777,1777,1778,5332,27,43,45,115,3900134,8742028,12953072,25595234,215578,0.015194147439504783,0.024198086662915026,0.02530933633295838,0.021567891972993247,0.23478260869565218,0.3739130434782609,0.391304347826087
City,Town of Scarborough,Maine,"Portland, ME",647,647,648,1942,71,121,87,279,10893780,50714270,58669800,120277850,459139,0.10973724884080371,0.18701700154559506,0.13425925925925927,0.14366632337796087,0.25448028673835127,0.4336917562724014,0.3118279569892473
City,Town of Kennebunkport,Maine,"Portland, ME",774,774,775,2323,45,117,274,436,14116273,70261180,326429111,410806564,758400.5,0.05813953488372093,0.1511627906976744,0.3535483870967742,0.18768833405079638,0.10321100917431193,0.268348623853211,0.6284403669724771
City,Town of Kennebunk,Maine,"Portland, ME",1733,1733,1735,5201,2,7,223,232,405395,2153700,199965683,202524778,664806,0.001154068090017311,0.004039238315060588,0.12853025936599424,0.04460680638338781,0.008620689655172414,0.03017241379310345,0.9612068965517241
City,Pennsville Township,New Jersey,"Philadelphia, PA",1539,1539,1540,4618,893,784,808,2485,91422580,109890351,154216087,355529018,136257,0.5802469135802469,0.5094217024041585,0.5246753246753246,0.5381117366825465,0.35935613682092554,0.3154929577464789,0.32515090543259556
City,Kailua,Hawaii,"Honolulu, HI",4309,4307,4308,12924,582,347,273,1202,446181018,351181078,410557151,1207919247,925565.5,0.1350661406358784,0.08056651961922452,0.06337047353760446,0.09300526152893841,0.4841930116472546,0.28868552412645593,0.2271214642262895
City,Gilgo-Oak Beach-Captree,New York,"New York, NY",114,114,114,342,92,102,89,283,36249377,61437616,95173645,192860638,583154,0.8070175438596491,0.8947368421052632,0.7807017543859649,0.827485380116959,0.3250883392226148,0.36042402826855124,0.31448763250883394
City,Bowers,Delaware,"Dover, DE",112,112,114,338,111,111,109,331,10970884,14769717,22880162,48620763,128620,0.9910714285714286,0.9910714285714286,0.956140350877193,0.9792899408284024,0.33534743202416917,0.33534743202416917,0.3293051359516616
City,Dania Beach,Florida,"Miami, FL",3360,3360,3360,10080,2831,2673,2760,8264,341788554,509128251,932080878,1782997683,188302.5,0.8425595238095238,0.7955357142857142,0.8214285714285714,0.8198412698412698,0.3425701839303001,0.3234511132623427,0.3339787028073572
City,Roosevelt Gardens,Florida,"Miami, FL",173,173,174,520,48,29,39,116,6897497,4967405,9025675,20890577,162139.5,0.2774566473988439,0.1676300578034682,0.22413793103448276,0.2230769230769231,0.41379310344827586,0.25,0.33620689655172414
City,Palm River-Clair Mel,Florida,"Tampa, FL",1692,1692,1694,5078,56,82,264,402,4448530,9348838,50982544,64779912,132677.5,0.03309692671394799,0.04846335697399527,0.15584415584415584,0.07916502560063017,0.13930348258706468,0.20398009950248755,0.6567164179104478
City,Hutchinson Island South,Florida,"Port Saint Lucie, FL",2954,2958,2950,8862,2762,1927,1016,5705,438271756,549779842,640655677,1628707275,246837,0.9350033852403521,0.6514536849222448,0.34440677966101696,0.6437598736176935,0.484136722173532,0.33777388255915863,0.17808939526730938
City,Ocean Township,New Jersey,"New York, NY",1486,1486,1487,4459,408,662,327,1397,75320908,198871091,169306914,443498913,300728,0.27456258411843876,0.44549125168236875,0.2199058507061197,0.3132989459520072,0.29205440229062274,0.47387258410880456,0.23407301360057264
City,Elsinboro Township,New Jersey,"Philadelphia, PA",180,180,182,542,136,145,137,418,14098264,21469619,31572499,67140382,148390.5,0.7555555555555555,0.8055555555555556,0.7527472527472527,0.7712177121771218,0.3253588516746411,0.34688995215311,0.3277511961722488
City,Hazlet,New Jersey,"New York, NY",2126,2126,2127,6379,224,55,24,303,55395118,17935072,9664458,82994648,264437,0.10536218250235184,0.025870178739416744,0.011283497884344146,0.04749960808904217,0.7392739273927392,0.18151815181518152,0.07920792079207921
City,Town of Nantucket,Massachusetts,NA,2943,2943,2944,8830,71,227,320,618,68484844,405454241,1319644892,1793583977,2242050.5,0.024125042473666328,0.07713217804960924,0.10869565217391304,0.06998867497168743,0.11488673139158576,0.3673139158576052,0.517799352750809
City,Town of Sandwich,Massachusetts,"East Falmouth, MA",1845,1845,1846,5536,8,19,134,161,2107194,6917712,109983520,119008426,694024,0.004336043360433604,0.010298102981029811,0.07258938244853738,0.029082369942196533,0.049689440993788817,0.11801242236024845,0.8322981366459627
City,Town of Marshfield,Massachusetts,"Boston, MA",3449,3449,3451,10349,991,561,395,1947,312230187,246294744,266033485,824558416,383059,0.28732966077123806,0.16265584227312263,0.11445957693422197,0.1881341192385738,0.5089881869542886,0.288135593220339,0.20287621982537238
City,Cutler Bay,Florida,"Miami, FL",4672,4672,4672,14016,623,325,700,1648,97442872,91521063,234083995,423047930,289002.5,0.13334760273972604,0.06956335616438356,0.14982876712328766,0.11757990867579908,0.3780339805825243,0.19720873786407767,0.42475728155339804
City,Town of Scituate,Massachusetts,"Boston, MA",2339,2339,2340,7018,197,208,159,564,84292285,117339759,149219322,350851366,553241.5,0.08422402736212056,0.08892689183411714,0.06794871794871794,0.08036477628954118,0.34929078014184395,0.36879432624113473,0.28191489361702127
City,Town of Groton,Connecticut,"Norwich, CT",1889,1889,1890,5668,7,14,130,151,1126887,3010502,94329845,98467234,530543,0.0037056643726839597,0.007411328745367919,0.06878306878306878,0.026640790402258294,0.046357615894039736,0.09271523178807947,0.8609271523178808
City,Orangetown,New York,"New York, NY",4143,4143,4143,12429,21,19,83,123,7368586,8605112,77027143,93000841,654270,0.005068790731354091,0.004586048756939416,0.020033791938209027,0.009896210475500844,0.17073170731707318,0.15447154471544716,0.6747967479674797
City,Downe Township,New Jersey,"Vineland, NJ",321,321,322,964,253,231,249,733,27755188,32841627,48571979,109168794,141620,0.7881619937694704,0.719626168224299,0.7732919254658385,0.7603734439834025,0.3451568894952251,0.3151432469304229,0.339699863574352
City,Bass River Township,New Jersey,"Philadelphia, PA",211,211,211,633,51,54,54,159,7608086,11524547,18109629,37242262,219127,0.24170616113744076,0.2559241706161137,0.2559241706161137,0.25118483412322273,0.32075471698113206,0.33962264150943394,0.33962264150943394
City,Maurice River Township,New Jersey,"Vineland, NJ",452,452,454,1358,116,98,117,331,13296316,14863440,28337549,56497305,149301,0.25663716814159293,0.2168141592920354,0.2577092511013216,0.24374079528718703,0.3504531722054381,0.29607250755287007,0.35347432024169184
City,Branford,Connecticut,"New Haven, CT",3334,3334,3334,10002,94,184,313,591,20060627,55861596,234500396,310422619,376962,0.028194361127774445,0.055188962207558485,0.09388122375524895,0.059088182363527295,0.15905245346869712,0.311336717428088,0.5296108291032149
City,Long Beach Township,New Jersey,"New York, NY",1956,1956,1958,5870,1889,1609,1238,4736,1083839809,1355726470,1819291426,4258857705,788525,0.9657464212678937,0.8225971370143149,0.6322778345250255,0.8068143100511074,0.3988597972972973,0.33973817567567566,0.26140202702702703
City,Chatham,Massachusetts,"East Falmouth, MA",2247,2247,2248,6742,45,70,149,264,14917902,50053259,319148156,384119317,1160615,0.020026702269692925,0.03115264797507788,0.06628113879003558,0.03915752002373183,0.17045454545454544,0.26515151515151514,0.5643939393939394
City,Middletown,New Jersey,"New York, NY",6748,6748,6750,20246,2172,420,168,2760,492221670,159307560,112416460,763945690,244460.5,0.3218731475992887,0.06224066390041494,0.024888888888888887,0.13632322434061048,0.7869565217391304,0.15217391304347827,0.06086956521739131
City,West Deptford Township,New Jersey,"Philadelphia, PA",2269,2269,2271,6809,120,50,22,192,17177084,9182495,6656421,33016e3,158276,0.052886734244160426,0.022036139268400177,0.009687362395420519,0.02819797327067117,0.625,0.2604166666666667,0.11458333333333333
City,Carneys Point Township,New Jersey,"Philadelphia, PA",875,875,875,2625,364,247,106,717,30676746,30544076,18612573,79833395,101632,0.416,0.2822857142857143,0.12114285714285715,0.27314285714285713,0.5076708507670851,0.34449093444909346,0.14783821478382148
City,Upper Township,New Jersey,"Upper Township, NJ",1668,1668,1670,5006,184,89,86,359,36428403,24751650,51856898,113036951,247894,0.11031175059952038,0.053357314148681056,0.05149700598802395,0.07171394326807831,0.5125348189415042,0.2479108635097493,0.2395543175487465
City,Town of Falmouth,Massachusetts,"East Falmouth, MA",1914,1914,1914,5742,27,218,243,488,11491629,143425657,356050751,510968037,689936,0.014106583072100314,0.11389759665621735,0.12695924764890282,0.08498780912574017,0.055327868852459015,0.44672131147540983,0.4979508196721312
City,Clinton,Connecticut,"Hartford, CT",1914,1914,1916,5744,297,69,284,650,53745341,18287147,166950652,238983140,260404,0.15517241379310345,0.03605015673981191,0.14822546972860126,0.11316155988857939,0.45692307692307693,0.10615384615384615,0.4369230769230769
City,Orleans,Massachusetts,"East Falmouth, MA",1611,1611,1611,4833,26,40,70,136,10310418,26820618,130047059,167178095,889380,0.016139044072004966,0.024829298572315334,0.043451272501551834,0.02813987171529071,0.19117647058823528,0.29411764705882354,0.5147058823529411
City,Guilford,Connecticut,"New Haven, CT",2284,2284,2284,6852,54,61,127,242,15779097,24608525,146695175,187082797,481213,0.023642732049036778,0.026707530647985988,0.05560420315236427,0.03531815528312901,0.2231404958677686,0.25206611570247933,0.5247933884297521
City,South Hackensack Township,New Jersey,"New York, NY",173,173,175,521,42,56,61,159,14726144,24047079,34022924,72796147,435752,0.24277456647398843,0.3236994219653179,0.3485714285714286,0.30518234165067176,0.2641509433962264,0.3522012578616352,0.3836477987421384
City,Middle Township,New Jersey,"Upper Township, NJ",1507,1507,1508,4522,909,368,536,1813,142613501,87020446,400308912,629942859,190979,0.6031851360318513,0.24419376244193763,0.35543766578249336,0.40092879256965946,0.5013789299503585,0.2029784886927744,0.29564258135686705
City,Dennis Township,New Jersey,"Upper Township, NJ",920,920,922,2762,30,41,43,114,5297562,9999655,16594389,31891606,251446,0.03260869565217391,0.04456521739130435,0.046637744034707156,0.041274438812454746,0.2631578947368421,0.35964912280701755,0.37719298245614036
City,Town of Hampton,New Hampshire,"Boston, MA",2830,2830,2831,8491,1199,537,483,2219,192240598,180858494,294398161,667497253,280387,0.42367491166077736,0.18975265017667844,0.17061109148710704,0.26133553173948887,0.5403334835511492,0.242000901306895,0.21766561514195584
City,Grant-Valkaria,Florida,"Palm Bay, FL",583,583,584,1750,84,23,60,167,17555918,7883938,38772605,64212461,300338,0.14408233276157806,0.03945111492281304,0.10273972602739725,0.09542857142857143,0.5029940119760479,0.1377245508982036,0.3592814371257485
City,Town of Westerly,Rhode Island,"Providence, RI",3302,3302,3303,9907,25,90,549,664,4162657,34605201,527506519,566274377,595975,0.007571168988491823,0.027256208358570563,0.16621253405994552,0.06702331684667406,0.03765060240963856,0.1355421686746988,0.8268072289156626
City,Mullica Township,New Jersey,"Egg Harbor Township, NJ",581,581,583,1745,45,57,101,203,5559881,9598644,28993442,44151967,186551,0.0774526678141136,0.0981067125645439,0.1732418524871355,0.11633237822349571,0.22167487684729065,0.28078817733990147,0.4975369458128079
City,Plymouth,Massachusetts,"Boston, MA",7280,7280,7282,21842,88,53,62,203,20279777,18812608,34252256,73344641,333783,0.012087912087912088,0.00728021978021978,0.008514144465806098,0.009294020694075634,0.43349753694581283,0.26108374384236455,0.3054187192118227
City,Provincetown,Massachusetts,"East Falmouth, MA",1182,1182,1184,3548,354,228,230,812,110277056,130116751,294872524,535266331,492802,0.29949238578680204,0.19289340101522842,0.19425675675675674,0.22886133032694475,0.43596059113300495,0.28078817733990147,0.2832512315270936
City,Town of Salisbury,Massachusetts,"Boston, MA",1207,1207,1207,3621,397,402,267,1066,97107624,144525464,148436992,390070080,342026,0.32891466445733225,0.33305716652858325,0.2212096106048053,0.2943938138635736,0.3724202626641651,0.3771106941838649,0.25046904315197
City,Town of Duxbury,Massachusetts,"Boston, MA",1835,1835,1837,5507,68,33,104,205,27502095,20467664,190950419,238920178,749341,0.037057220708446865,0.017983651226158037,0.056614044637996734,0.03722534955511168,0.33170731707317075,0.16097560975609757,0.5073170731707317
City,New Shoreham,Rhode Island,"Providence, RI",506,506,506,1518,57,25,48,130,44110017,27543698,93834928,165488643,1072092,0.11264822134387352,0.04940711462450593,0.09486166007905138,0.08563899868247694,0.43846153846153846,0.19230769230769232,0.36923076923076925
City,Yarmouth,Massachusetts,"East Falmouth, MA",5178,5178,5180,15536,472,184,529,1185,94354044,58623932,453170623,606148599,332409,0.09115488605639242,0.035534955581305525,0.10212355212355212,0.07627445932028837,0.3983122362869198,0.15527426160337554,0.44641350210970465
City,Town of Hingham,Massachusetts,"Boston, MA",2462,2462,2462,7386,48,33,52,133,24098382,24198331,82662230,130958943,731420,0.01949634443541836,0.013403736799350122,0.021121039805036556,0.01800704034660168,0.3609022556390977,0.24812030075187969,0.39097744360902253
Zip,1905,Massachusetts,NA,1703,1625,1354,4682,331,67,124,522,76932349,22119662,54693393,153745404,268205,0.19436288901937757,0.04123076923076923,0.0915805022156573,0.11149081589064502,0.6340996168582376,0.12835249042145594,0.23754789272030652
Zip,1906,Massachusetts,NA,2902,2882,2841,8625,206,185,194,585,68262864,74495031,99677520,242435415,395997,0.0709855272226051,0.06419153365718251,0.06828581485392468,0.06782608695652174,0.35213675213675216,0.3162393162393162,0.3316239316239316
Zip,1907,Massachusetts,NA,1607,1648,1637,4892,48,34,36,118,17181539,16345266,37022701,70549506,462773.5,0.029869321717486,0.02063106796116505,0.021991447770311544,0.0241210139002453,0.4067796610169492,0.288135593220339,0.3050847457627119
Zip,1908,Massachusetts,NA,402,460,458,1320,54,72,57,183,21553028,40494371,48682168,110729567,561186,0.13432835820895522,0.1565217391304348,0.12445414847161572,0.13863636363636364,0.29508196721311475,0.39344262295081966,0.3114754098360656
Zip,1923,Massachusetts,NA,2766,2770,2764,8300,64,24,64,152,12400477,10361729,53111506,75873712,424858,0.023138105567606652,0.008664259927797834,0.023154848046309694,0.018313253012048194,0.42105263157894735,0.15789473684210525,0.42105263157894735
Zip,1930,Massachusetts,NA,3579,3575,3577,10731,96,97,188,381,29711733,41145862,191777160,262634755,489543,0.026823134953897737,0.027132867132867132,0.052558009505171935,0.03550461280402572,0.25196850393700787,0.2545931758530184,0.49343832020997375
Zip,1944,Massachusetts,NA,650,652,662,1964,47,33,51,131,22623111,27736155,125550086,175909352,852553,0.07230769230769231,0.05061349693251534,0.0770392749244713,0.06670061099796334,0.35877862595419846,0.25190839694656486,0.3893129770992366
Zip,1950,Massachusetts,NA,2249,2236,2237,6722,57,64,115,236,20137643,33682436,103723327,157543406,589352,0.025344597598932858,0.028622540250447227,0.051408135896289675,0.03510859863135971,0.24152542372881355,0.2711864406779661,0.4872881355932203
Zip,1951,Massachusetts,NA,502,563,656,1721,113,97,92,302,41909069,51550781,68366393,161826243,511296,0.2250996015936255,0.17229129662522202,0.1402439024390244,0.17547937245787332,0.3741721854304636,0.3211920529801324,0.304635761589404
Zip,1952,Massachusetts,NA,1223,1219,1206,3648,393,402,262,1057,96390778,144525464,145526676,386442918,342026,0.321340964840556,0.32977850697292865,0.21724709784411278,0.2897478070175439,0.3718070009460738,0.380321665089877,0.2478713339640492
Zip,1966,Massachusetts,NA,1141,1136,1125,3402,70,28,57,155,24743623,14245725,54130826,93120174,456015,0.06134969325153374,0.02464788732394366,0.050666666666666665,0.04556143445032334,0.45161290322580644,0.18064516129032257,0.36774193548387096
Zip,1970,Massachusetts,NA,3726,3737,3687,11150,213,170,245,628,53675104,65698163,153004162,272377429,398631,0.0571658615136876,0.04549103559004549,0.06644968809330079,0.05632286995515695,0.339171974522293,0.27070063694267515,0.39012738853503187
Zip,2025,Massachusetts,NA,900,906,923,2729,41,49,75,165,22539149,41724100,174006325,238269574,971064,0.04555555555555556,0.05408388520971302,0.08125677139761647,0.06046170758519604,0.24848484848484848,0.296969696969697,0.45454545454545453
Zip,2043,Massachusetts,NA,2410,2450,2492,7352,47,35,52,134,23497194,25515146,82662230,131674570,712744,0.01950207468879668,0.014285714285714285,0.02086677367576244,0.01822633297062024,0.35074626865671643,0.26119402985074625,0.3880597014925373
Zip,2045,Massachusetts,NA,1637,1631,1640,4908,828,873,464,2165,258218401,357642651,291743625,907604677,383234,0.5058032987171656,0.5352544451256898,0.28292682926829266,0.44111654441727793,0.38244803695150115,0.40323325635103924,0.2143187066974596
Zip,2050,Massachusetts,NA,3365,3268,3172,9805,934,433,240,1607,293870007,188969989,156570567,639410563,370274,0.2775631500742942,0.13249694002447981,0.07566204287515763,0.16389597144314125,0.581207218419415,0.26944617299315493,0.14934660858742999
Zip,2066,Massachusetts,NA,2407,2498,2569,7474,230,314,289,833,96029641,165309518,241360050,502699209,540147,0.09555463232239302,0.1257005604483587,0.11249513429349942,0.11145303719561145,0.27611044417767105,0.37695078031212487,0.3469387755102041
Zip,2108,Massachusetts,NA,127,197,1110,1434,16,32,431,479,7673598,18946159,1063450713,1090070470,1262626,0.12598425196850394,0.16243654822335024,0.38828828828828826,0.33403068340306835,0.033402922755741124,0.06680584551148225,0.8997912317327766
Zip,2109,Massachusetts,NA,180,328,772,1280,107,193,580,880,50640686,116436121,961950259,1129027066,904712.5,0.5944444444444444,0.5884146341463414,0.7512953367875648,0.6875,0.1215909090909091,0.21931818181818183,0.6590909090909091
Zip,2110,Massachusetts,NA,3,57,1021,1081,3,57,905,965,1278821,35613450,1037142261,1074034532,1004261,1,1,0.8863858961802155,0.8926919518963923,0.0031088082901554403,0.05906735751295337,0.9378238341968912
Zip,2111,Massachusetts,NA,44,438,1343,1825,10,33,295,338,3996431,20202799,351796786,375996016,965283.5,0.22727272727272727,0.07534246575342465,0.21965748324646314,0.1852054794520548,0.029585798816568046,0.09763313609467456,0.8727810650887574
Zip,2114,Massachusetts,NA,956,1035,1278,3269,35,181,188,404,15528981,110137882,299384319,425051182,686992.5,0.036610878661087864,0.1748792270531401,0.14710485133020346,0.12358519424900581,0.08663366336633663,0.44801980198019803,0.46534653465346537
Zip,2115,Massachusetts,NA,731,939,1451,3121,612,779,1006,2397,254187933,459847302,1559327371,2273362606,639339,0.8372093023255814,0.8296059637912673,0.6933149552033081,0.7680230695289971,0.2553191489361702,0.32498957029620357,0.4196912807676262
Zip,2116,Massachusetts,NA,493,1256,5055,6804,389,996,3505,4890,178225545,615121217,7225919111,8019265873,1062220,0.7890466531440162,0.7929936305732485,0.6933728981206726,0.718694885361552,0.07955010224948875,0.20368098159509201,0.7167689161554193
Zip,2118,Massachusetts,NA,366,1210,3632,5208,315,1012,3122,4449,133935793,631834037,4649641122,5415410952,865147,0.860655737704918,0.8363636363636363,0.8595814977973568,0.8542626728110599,0.07080242751180041,0.22746684648235557,0.701730726005844
Zip,2122,Massachusetts,NA,1819,1887,536,4242,60,90,19,169,23589553,53005577,15503156,92098286,548420,0.032985156679494226,0.04769475357710652,0.03544776119402985,0.03983969825553984,0.35502958579881655,0.5325443786982249,0.11242603550295859
Zip,2127,Massachusetts,NA,1717,3051,4419,9187,156,281,309,746,66375887,173506069,285468535,525350491,661319,0.09085614443797321,0.09210095050803016,0.06992532247114731,0.08120169805159465,0.20911528150134048,0.37667560321715815,0.41420911528150134
Zip,2128,Massachusetts,NA,2076,2372,1118,5566,546,663,356,1565,211216117,407581730,286929356,905727203,596430,0.2630057803468208,0.27951096121416524,0.3184257602862254,0.2811713977721883,0.3488817891373802,0.42364217252396164,0.22747603833865815
Zip,2129,Massachusetts,NA,484,1686,2920,5090,142,424,415,981,65050315,243584175,504031376,812665866,650182,0.29338842975206614,0.2514827995255042,0.1421232876712329,0.19273084479371316,0.14475025484199797,0.4322120285423038,0.4230377166156983
Zip,2138,Massachusetts,NA,2173,1825,3025,7023,137,149,334,620,72360381,122922719,637504960,832788060,1162912.5,0.06304647952139898,0.08164383561643836,0.11041322314049587,0.08828136124163463,0.22096774193548388,0.2403225806451613,0.5387096774193548
Zip,2139,Massachusetts,NA,2107,2114,2057,6278,579,639,541,1759,300232692,522419207,806822019,1629473918,792163,0.2747982914095871,0.3022705771050142,0.2630043753038405,0.28018477222045235,0.3291642978965321,0.3632745878339966,0.3075611142694713
Zip,2140,Massachusetts,NA,1344,1394,1188,3926,108,225,63,396,54895307,194280014,89488951,338664272,822286,0.08035714285714286,0.16140602582496413,0.05303030303030303,0.10086602139582272,0.2727272727272727,0.5681818181818182,0.1590909090909091
Zip,2141,Massachusetts,NA,988,1302,441,2731,506,853,216,1575,258071395,683894726,293018324,1234984445,740678,0.5121457489878543,0.6551459293394777,0.4897959183673469,0.576711827169535,0.32126984126984126,0.5415873015873016,0.13714285714285715
Zip,2142,Massachusetts,NA,105,147,157,409,105,146,156,407,59493409,119292724,219831289,398617422,895054,1,0.9931972789115646,0.9936305732484076,0.9951100244498777,0.257985257985258,0.35872235872235875,0.3832923832923833
Zip,2143,Massachusetts,NA,1444,1552,1568,4564,358,226,105,689,170042014,176176390,121751078,467969482,657573,0.24792243767313019,0.14561855670103094,0.06696428571428571,0.15096406660823838,0.5195936139332366,0.32801161103047893,0.15239477503628446
Zip,2148,Massachusetts,NA,3472,3495,3353,10320,399,225,190,814,129146955,97773583,125208318,352128856,388005,0.11491935483870967,0.06437768240343347,0.05666567253206084,0.07887596899224807,0.49017199017199015,0.2764127764127764,0.2334152334152334
Zip,2149,Massachusetts,NA,2687,2704,2598,7989,173,121,19,313,60029246,54593924,14025408,128648578,377429,0.06438407145515444,0.04474852071005917,0.007313317936874519,0.03917887094755289,0.5527156549520766,0.3865814696485623,0.06070287539936102
Zip,2150,Massachusetts,NA,1679,1663,1661,5003,210,143,93,446,53788922,60709694,78405476,192904092,362381.5,0.12507444907683143,0.08598917618761275,0.055990367248645395,0.08914651209274435,0.47085201793721976,0.32062780269058294,0.2085201793721973
Zip,2151,Massachusetts,NA,3790,3792,3755,11337,1230,651,663,2544,360265164,273879873,425167547,1059312584,378542,0.3245382585751979,0.17167721518987342,0.17656458055925434,0.22439798888594867,0.4834905660377358,0.25589622641509435,0.2606132075471698
Zip,2152,Massachusetts,NA,1593,1594,1589,4776,412,358,411,1181,138862897,173676393,318231860,630771150,485967,0.258631512868801,0.2245922208281054,0.25865324103209564,0.2472780569514238,0.3488569009314141,0.30313293818797626,0.34801016088060965
Zip,2155,Massachusetts,NA,5132,5064,4997,15193,910,570,501,1981,400929012,336166076,478609219,1215704307,521263,0.17731878409976617,0.11255924170616113,0.1002601560936562,0.13038899493187653,0.45936395759717313,0.2877334679454821,0.25290257445734476
Zip,2169,Massachusetts,NA,5465,4257,3373,13095,384,211,242,837,127839845,92176300,154328926,374345071,404600,0.07026532479414456,0.049565421658444915,0.07174621998221169,0.06391752577319587,0.45878136200716846,0.2520908004778972,0.2891278375149343
Zip,2170,Massachusetts,NA,740,1777,2253,4770,127,282,258,667,41682903,126670806,153882398,322236107,467298,0.17162162162162162,0.1586944288126055,0.11451398135818908,0.139832285115304,0.1904047976011994,0.42278860569715143,0.3868065967016492
Zip,2171,Massachusetts,NA,1567,1743,2082,5392,711,395,294,1400,206704291,173686860,194811717,575202868,390697,0.45373324824505423,0.22662076878944348,0.14121037463976946,0.2596439169139466,0.5078571428571429,0.28214285714285714,0.21
Zip,2191,Massachusetts,NA,1188,1222,725,3135,110,70,74,254,27170276,26144255,39364940,92679471,361718,0.09259259259259259,0.057283142389525366,0.10206896551724139,0.0810207336523126,0.4330708661417323,0.27559055118110237,0.29133858267716534
Zip,2199,Massachusetts,NA,0,0,113,113,0,0,109,109,0,0,532049660,532049660,4206469,0,0,0.9646017699115044,0.9646017699115044,0,0,1
Zip,2210,Massachusetts,NA,38,119,530,687,38,104,373,515,17168141,65025613,473985912,556179666,888437,1,0.8739495798319328,0.7037735849056603,0.7496360989810772,0.07378640776699029,0.20194174757281552,0.7242718446601941
Zip,2215,Massachusetts,NA,943,628,634,2205,672,481,387,1540,276859589,287884189,531703598,1096447376,536290.5,0.7126193001060446,0.7659235668789809,0.610410094637224,0.6984126984126984,0.43636363636363634,0.31233766233766236,0.2512987012987013
Zip,2332,Massachusetts,NA,1819,1843,1853,5515,65,41,107,213,26456846,24080333,193100574,243637753,704883,0.035733919736118745,0.02224633749321758,0.05774419859686994,0.038621940163191294,0.3051643192488263,0.19248826291079812,0.5023474178403756
Zip,2360,Massachusetts,NA,7286,7288,7296,21870,89,53,62,204,20425914,18812608,34252256,73490778,333170,0.012215207246774636,0.007272228320526894,0.00849780701754386,0.009327846364883402,0.4362745098039216,0.25980392156862747,0.30392156862745096
Zip,2474,Massachusetts,NA,2405,2286,2351,7042,312,138,118,568,121302059,96051297,104549230,321902586,579993.5,0.12972972972972974,0.06036745406824147,0.05019140791152701,0.08065890372053394,0.5492957746478874,0.24295774647887325,0.20774647887323944
Zip,2536,Massachusetts,NA,3825,3744,3696,11265,9,34,335,378,2405384,13145552,343073064,358624e3,790531,0.002352941176470588,0.009081196581196582,0.09063852813852814,0.03355525965379494,0.023809523809523808,0.08994708994708994,0.8862433862433863
Zip,2537,Massachusetts,NA,943,964,1075,2982,55,22,82,159,16209236,10156566,75822772,102188574,540253,0.05832449628844114,0.022821576763485476,0.07627906976744186,0.05331991951710262,0.34591194968553457,0.13836477987421383,0.5157232704402516
Zip,2539,Massachusetts,NA,1508,1502,1548,4558,3,12,137,152,1399495,12893365,486126580,500419440,2485136,0.001989389920424403,0.007989347536617843,0.08850129198966408,0.03334795963141729,0.019736842105263157,0.07894736842105263,0.9013157894736842
Zip,2540,Massachusetts,NA,1892,1981,1957,5830,30,218,244,492,12840958,143424103,362437677,518702738,687642.5,0.015856236786469344,0.11004543160020192,0.12468063362289218,0.08439108061749571,0.06097560975609756,0.44308943089430897,0.4959349593495935
Zip,2554,Massachusetts,NA,2929,2922,2955,8806,70,227,321,618,67723161,405454241,1321181691,1794359093,2242050.5,0.023898941618299762,0.07768651608487337,0.10862944162436548,0.07017942312059959,0.11326860841423948,0.3673139158576052,0.5194174757281553
Zip,2556,Massachusetts,NA,802,775,795,2372,27,35,81,143,10414549,18483608,105906208,134804365,758859,0.03366583541147132,0.04516129032258064,0.1018867924528302,0.0602866779089376,0.1888111888111888,0.24475524475524477,0.5664335664335665
Zip,2557,Massachusetts,NA,1325,1095,1192,3612,40,50,120,210,19015657,31874096,182075323,232965076,747095.5,0.03018867924528302,0.045662100456621,0.10067114093959731,0.05813953488372093,0.19047619047619047,0.23809523809523808,0.5714285714285714
Zip,2563,Massachusetts,NA,1591,1591,1503,4685,10,18,84,112,2792048,6568227,60884541,70244816,602890,0.006285355122564425,0.011313639220615965,0.05588822355289421,0.02390608324439701,0.08928571428571429,0.16071428571428573,0.75
Zip,2568,Massachusetts,NA,1125,1062,1135,3322,43,16,81,140,17998465,12771443,172417555,203187463,1108573,0.03822222222222222,0.015065913370998116,0.07136563876651983,0.04214328717639976,0.30714285714285716,0.11428571428571428,0.5785714285714286
Zip,2571,Massachusetts,NA,2462,2135,2081,6678,187,192,298,677,36400039,51835049,142985423,231220511,295040,0.07595450852965069,0.08992974238875878,0.14320038443056224,0.10137765798143157,0.276218611521418,0.28360413589364847,0.4401772525849335
Zip,2601,Massachusetts,NA,4236,1252,947,6435,21,45,105,171,5526880,17349041,119642676,142518597,568996,0.004957507082152974,0.035942492012779555,0.11087645195353749,0.026573426573426574,0.12280701754385964,0.2631578947368421,0.6140350877192983
Zip,2630,Massachusetts,NA,54,402,943,1399,7,20,78,105,2096143,7630832,85459132,95186107,670906,0.12962962962962962,0.04975124378109453,0.08271474019088017,0.07505360972122944,0.06666666666666667,0.19047619047619047,0.7428571428571429
Zip,2632,Massachusetts,NA,1721,2658,1404,5783,21,46,139,206,4994044,18768953,154462737,178225734,659258,0.01220220801859384,0.01730624529721595,0.099002849002849,0.035621649662804775,0.10194174757281553,0.22330097087378642,0.6747572815533981
Zip,2633,Massachusetts,NA,1518,1548,1732,4798,23,52,115,190,9255530,36088860,240911161,286255551,1265637.5,0.015151515151515152,0.03359173126614987,0.06639722863741339,0.03959983326385994,0.12105263157894737,0.2736842105263158,0.6052631578947368
Zip,2638,Massachusetts,NA,598,1013,2265,3876,8,32,95,135,2046966,12310760,80208212,94565938,577420,0.013377926421404682,0.0315893385982231,0.04194260485651214,0.0348297213622291,0.05925925925925926,0.23703703703703705,0.7037037037037037
Zip,2639,Massachusetts,NA,1938,1328,521,3787,166,73,39,278,33456860,26045053,32877198,92379111,271796.5,0.08565531475748193,0.054969879518072286,0.07485604606525911,0.07340903089516768,0.5971223021582733,0.26258992805755393,0.14028776978417265
Zip,2642,Massachusetts,NA,1892,1893,1907,5692,14,14,112,140,4309238,6393994,110010674,120713906,681939,0.007399577167019027,0.007395668251452721,0.05873099108547457,0.024595924104005622,0.1,0.1,0.8
Zip,2646,Massachusetts,NA,651,701,762,2114,67,27,65,159,20143783,14057635,149118362,183319780,507870,0.10291858678955453,0.03851640513552068,0.08530183727034121,0.07521286660359508,0.42138364779874216,0.16981132075471697,0.4088050314465409
Zip,2649,Massachusetts,NA,3171,3197,3218,9586,1,44,250,295,351145,19743549,340246337,360341031,997446,3.15357931251971e-4,0.01376290272130122,0.07768800497203232,0.030774045482996035,0.003389830508474576,0.14915254237288136,0.847457627118644
Zip,2653,Massachusetts,NA,1602,1607,1606,4815,26,40,69,135,10310418,26820618,128599930,165730966,888010,0.016229712858926344,0.024891101431238332,0.04296388542963885,0.028037383177570093,0.1925925925925926,0.2962962962962963,0.5111111111111111
Zip,2657,Massachusetts,NA,1184,1185,1190,3559,354,228,232,814,110435868,130116751,297253066,537805685,492802,0.2989864864864865,0.19240506329113924,0.1949579831932773,0.22871593144141614,0.4348894348894349,0.2800982800982801,0.28501228501228504
Zip,2664,Massachusetts,NA,1750,2342,1880,5972,378,121,212,711,72888404,38434310,163215739,274538453,265095,0.216,0.05166524338172502,0.1127659574468085,0.11905559276624246,0.5316455696202531,0.170182841068917,0.2981715893108298
Zip,2666,Massachusetts,NA,889,861,842,2592,130,26,43,199,41231726,17635795,53556536,112424057,388998,0.14623172103487064,0.030197444831591175,0.0510688836104513,0.07677469135802469,0.6532663316582915,0.1306532663316583,0.21608040201005024
Zip,2667,Massachusetts,NA,1231,1245,1262,3738,61,51,121,233,23702963,31009457,137314032,192026452,732863,0.04955320877335499,0.04096385542168675,0.09587955625990491,0.062332798287854464,0.26180257510729615,0.21888412017167383,0.51931330472103
Zip,2670,Massachusetts,NA,559,676,703,1938,108,100,152,360,22875166,36063709,112506308,171445183,378513,0.19320214669051877,0.14792899408284024,0.21621621621621623,0.18575851393188855,0.3,0.2777777777777778,0.4222222222222222
Zip,2673,Massachusetts,NA,2764,1802,1354,5920,91,55,249,395,20821014,17506855,241064942,279392811,436704,0.0329232995658466,0.030521642619311874,0.18389955686853768,0.06672297297297297,0.23037974683544304,0.13924050632911392,0.6303797468354431
Zip,2719,Massachusetts,NA,2042,2046,2028,6116,180,172,386,738,37470711,45950029,173725833,257146573,312590.5,0.0881488736532811,0.08406647116324535,0.1903353057199211,0.12066710268149117,0.24390243902439024,0.23306233062330622,0.5230352303523035
Zip,2738,Massachusetts,NA,788,792,799,2379,33,39,81,153,10238758,19091551,125203900,154534209,642348,0.04187817258883249,0.04924242424242424,0.10137672090112641,0.06431273644388398,0.21568627450980393,0.2549019607843137,0.5294117647058824
Zip,2739,Massachusetts,NA,1028,1036,1043,3107,89,101,187,377,27304825,46841344,159107910,233254079,529425,0.08657587548638132,0.09749034749034749,0.17929050814956854,0.12133891213389121,0.23607427055702918,0.26790450928381965,0.4960212201591512
Zip,2748,Massachusetts,NA,1278,1270,2229,4777,13,13,132,158,2748729,4683054,161960465,169392248,695188,0.010172143974960876,0.010236220472440945,0.059219380888290714,0.03307515176889261,0.08227848101265822,0.08227848101265822,0.8354430379746836
Zip,2777,Massachusetts,NA,2041,2020,2015,6076,67,38,57,162,14426928,10620812,24266006,49313746,268642,0.03282704556589907,0.01881188118811881,0.028287841191066997,0.026662277814351546,0.41358024691358025,0.2345679012345679,0.35185185185185186
Zip,2806,Rhode Island,NA,1900,1987,1996,5883,56,92,131,279,16731441,39581082,117852686,174165209,478135,0.029473684210526315,0.0463009562154001,0.0656312625250501,0.04742478327383988,0.2007168458781362,0.32974910394265233,0.46953405017921146
Zip,2809,Rhode Island,NA,2318,2349,2295,6962,20,29,78,127,4933431,9538329,52911195,67382955,410603,0.008628127696289905,0.012345679012345678,0.03398692810457516,0.018241884515943694,0.15748031496062992,0.2283464566929134,0.6141732283464567
Zip,2813,Rhode Island,NA,1578,1574,1593,4745,6,28,323,357,1765169,11460854,294243745,307469768,798617,0.0038022813688212928,0.017789072426937738,0.20276208411801633,0.07523709167544784,0.01680672268907563,0.0784313725490196,0.9047619047619048
Zip,2840,Rhode Island,NA,2588,2596,2600,7784,104,187,158,449,33486760,86829251,223917608,344233619,483964,0.0401854714064915,0.07203389830508475,0.06076923076923077,0.05768242548818089,0.23162583518930957,0.41648106904231624,0.3518930957683742
Zip,2852,Rhode Island,NA,2999,2662,2063,7724,8,54,163,225,2197541,19856735,107388638,129442914,495616,0.00266755585195065,0.0202854996243426,0.07901114881240912,0.029129984464008284,0.035555555555555556,0.24,0.7244444444444444
Zip,2871,Rhode Island,NA,2360,2316,2370,7046,79,64,32,175,17108392,23420631,20618858,61147881,311571,0.03347457627118644,0.027633851468048358,0.01350210970464135,0.024836786829406755,0.4514285714285714,0.3657142857142857,0.18285714285714286
Zip,2879,Rhode Island,NA,2988,2831,3704,9523,166,67,251,484,31852375,23790604,182158926,237801905,425330,0.05555555555555555,0.023666548922642177,0.0677645788336933,0.05082432006720571,0.34297520661157027,0.1384297520661157,0.518595041322314
Zip,2882,Rhode Island,NA,1796,2348,3815,7959,92,84,285,461,41739086,43671832,283619323,369030241,658488,0.051224944320712694,0.03577512776831346,0.07470511140235911,0.05792184947857771,0.19956616052060738,0.1822125813449024,0.6182212581344902
Zip,2885,Rhode Island,NA,1172,1175,1154,3501,217,46,46,309,42011039,12720783,20303826,75035648,217685,0.18515358361774745,0.03914893617021276,0.03986135181975736,0.08826049700085689,0.7022653721682848,0.1488673139158576,0.1488673139158576
Zip,2889,Rhode Island,NA,3710,3738,3127,10575,57,43,292,392,9051732,9369351,101394782,119815865,279661.5,0.015363881401617251,0.011503477795612628,0.09338023664854493,0.03706855791962175,0.14540816326530612,0.1096938775510204,0.7448979591836735
Zip,2891,Rhode Island,NA,3280,3254,3236,9770,25,86,539,650,4162657,33005842,522292910,559461409,604778,0.007621951219512195,0.02642901044867855,0.1665636588380717,0.06653019447287616,0.038461538461538464,0.13230769230769232,0.8292307692307692
Zip,3801,New Hampshire,NA,3189,3226,3233,9648,0,17,117,134,0,6821666,93333903,100155569,697497.5,0,0.0052696838189708614,0.036189297865759355,0.013888888888888888,0,0.12686567164179105,0.8731343283582089
Zip,3842,New Hampshire,NA,3001,2914,2885,8800,1256,560,511,2327,201221051,192917564,312645370,706783985,280676,0.4185271576141286,0.19217570350034316,0.17712305025996533,0.26443181818181816,0.5397507520412549,0.2406532015470563,0.21959604641168887
Zip,3870,New Hampshire,NA,871,864,813,2548,90,133,198,421,41694687,99741549,300319567,441755803,839104,0.10332950631458095,0.15393518518518517,0.24354243542435425,0.1652276295133438,0.21377672209026127,0.3159144893111639,0.47030878859857483
Zip,3874,New Hampshire,NA,1392,1364,1340,4096,87,50,433,570,11043772,13965468,276646248,301655488,547567,0.0625,0.036656891495601175,0.32313432835820893,0.13916015625,0.15263157894736842,0.08771929824561403,0.7596491228070176
Zip,3909,Maine,NA,3105,3214,5227,11546,59,17,44,120,11851656,6095463,42975011,60922130,328692,0.019001610305958132,0.005289359054138146,0.008417830495504113,0.010393209769617183,0.49166666666666664,0.14166666666666666,0.36666666666666664
Zip,4005,Maine,NA,2152,2122,2018,6292,0,3,250,253,0,704477,206193548,206898025,677505,0,0.001413760603204524,0.12388503468780972,0.04020979020979021,0,0.011857707509881422,0.9881422924901185
Zip,4043,Maine,NA,1736,1719,1736,5191,2,7,222,231,405395,2153700,196599088,199158183,664766,0.001152073732718894,0.004072134962187318,0.12788018433179724,0.04450009632055481,0.008658008658008658,0.030303030303030304,0.961038961038961
Zip,4046,Maine,NA,1295,1331,1664,4290,43,124,285,452,13468468,71807560,332980847,418256875,752483.5,0.033204633204633204,0.09316303531179564,0.17127403846153846,0.10536130536130536,0.09513274336283185,0.2743362831858407,0.6305309734513275
Zip,4064,Maine,NA,1946,1925,1756,5627,147,255,363,765,26569289,62121621,150666405,239357315,287800,0.07553956834532374,0.13246753246753246,0.20671981776765375,0.13595166163141995,0.19215686274509805,0.3333333333333333,0.4745098039215686
Zip,4072,Maine,NA,2056,2137,2075,6268,2,15,156,173,357152,3495171,60754090,64606413,349213,9.727626459143969e-4,0.0070191857744501636,0.07518072289156627,0.02760051052967454,0.011560693641618497,0.08670520231213873,0.9017341040462428
Zip,4074,Maine,NA,663,603,634,1900,67,120,87,274,10236667,50343859,58669800,119250326,460141,0.10105580693815988,0.19900497512437812,0.13722397476340695,0.14421052631578948,0.24452554744525548,0.43795620437956206,0.3175182481751825
Zip,4079,Maine,NA,934,949,1078,2961,48,61,86,195,12333154,23062216,52659912,88055282,440929,0.05139186295503212,0.0642781875658588,0.07977736549165121,0.06585612968591692,0.24615384615384617,0.3128205128205128,0.441025641025641
Zip,4090,Maine,NA,4353,4187,4262,12802,73,92,896,1061,8119063,16292102,709893936,734305101,568762,0.01677004364805881,0.0219727728684022,0.21022993899577663,0.08287767536322449,0.06880301602262016,0.08671065032987747,0.8444863336475024
Zip,4101,Maine,NA,342,760,1770,2872,5,41,161,207,915111,11325486,80586288,92826885,491674,0.014619883040935672,0.05394736842105263,0.09096045197740113,0.07207520891364902,0.024154589371980676,0.19806763285024154,0.7777777777777778
Zip,6320,Connecticut,NA,1880,1834,1828,5542,18,17,88,123,2155760,2669361,29061380,33886501,214925,0.009574468085106383,0.009269356597600873,0.04814004376367615,0.022194153735113676,0.14634146341463414,0.13821138211382114,0.7154471544715447
Zip,6340,Connecticut,NA,2812,2562,1863,7237,118,137,260,515,57310628,87292615,268287429,412890672,645782,0.041963015647226175,0.053473848555815766,0.13955984970477725,0.07116208373635484,0.229126213592233,0.26601941747572816,0.5048543689320388
Zip,6357,Connecticut,NA,1677,1713,1698,5088,9,26,84,119,2039256,7230115,48675836,57945207,437271,0.005366726296958855,0.015178050204319907,0.04946996466431095,0.023388364779874212,0.07563025210084033,0.2184873949579832,0.7058823529411765
Zip,6385,Connecticut,NA,2102,2175,2418,6695,7,21,77,105,1319907,4918493,40456648,46695048,385435,0.003330161750713606,0.009655172413793104,0.03184449958643507,0.01568334578043316,0.06666666666666667,0.2,0.7333333333333333
Zip,6405,Connecticut,NA,3333,3296,3338,9967,94,185,317,596,20060627,56304550,237833756,314198933,381976,0.028202820282028203,0.05612864077669903,0.09496704613541043,0.05979733119293669,0.15771812080536912,0.3104026845637584,0.5318791946308725
Zip,6413,Connecticut,NA,1920,1916,1926,5762,299,78,288,665,54411547,22391326,170004556,246807429,267421,0.15572916666666667,0.0407098121085595,0.14953271028037382,0.11541131551544602,0.4496240601503759,0.11729323308270677,0.4330827067669173
Zip,6437,Connecticut,NA,2359,2631,3583,8573,53,60,126,239,15634812,24165571,145496746,185297129,481231,0.022467147096227214,0.02280501710376283,0.035166061959252023,0.027878222325906917,0.2217573221757322,0.2510460251046025,0.5271966527196653
Zip,6443,Connecticut,NA,2347,2357,2357,7061,47,31,260,338,15272735,14327813,321501529,351102077,802840,0.020025564550489986,0.013152312261349173,0.1103097157403479,0.04786857385639428,0.1390532544378698,0.09171597633136094,0.7692307692307693
Zip,6460,Connecticut,NA,4684,4517,4099,13300,393,373,696,1462,78790695,111305464,429032214,619128373,328426,0.08390264730999146,0.08257693159176445,0.16979751158819223,0.10992481203007519,0.26880984952120385,0.2551299589603283,0.47606019151846785
Zip,6475,Connecticut,NA,1747,1743,1785,5275,412,296,374,1082,114990438,112804586,350163734,577958758,372594.5,0.2358328563251288,0.16982214572576018,0.20952380952380953,0.20511848341232228,0.3807763401109057,0.2735674676524954,0.3456561922365989
Zip,6498,Connecticut,NA,1144,1156,1160,3460,44,137,327,508,10952094,45689664,238005269,294647027,474395.5,0.038461538461538464,0.1185121107266436,0.2818965517241379,0.14682080924855492,0.08661417322834646,0.26968503937007876,0.6437007874015748
Zip,6512,Connecticut,NA,2541,4209,3209,9959,158,380,666,1204,20698375,71518518,236764928,328981821,228758.5,0.06218024399842582,0.09028272748871466,0.2075412901215332,0.12089567225625063,0.13122923588039867,0.31561461794019935,0.553156146179402
Zip,6516,Connecticut,NA,4725,4726,4716,14167,340,79,117,536,48342416,14094616,37267809,99704841,153295,0.07195767195767196,0.016716038933559035,0.02480916030534351,0.03783440389637891,0.6343283582089553,0.14738805970149255,0.21828358208955223
Zip,6604,Connecticut,NA,1404,768,1391,3563,291,13,11,315,23054211,2275240,2563497,27892948,66888,0.20726495726495728,0.016927083333333332,0.007907979870596693,0.08840864440078586,0.9238095238095239,0.04126984126984127,0.03492063492063492
Zip,6605,Connecticut,NA,522,629,1525,2676,15,52,115,182,1372476,8341999,43916362,53630837,253689,0.028735632183908046,0.08267090620031796,0.07540983606557378,0.06801195814648729,0.08241758241758242,0.2857142857142857,0.6318681318681318
Zip,6615,Connecticut,NA,2853,1251,1582,5686,959,123,147,1229,140102023,29919708,59824770,229846501,163895,0.33613739922888186,0.09832134292565947,0.09292035398230089,0.21614491734083716,0.7803091944670464,0.1000813669650122,0.11960943856794141
Zip,6820,Connecticut,NA,2093,2125,2166,6384,9,41,194,244,8365323,66970170,813743450,889078943,2823623.5,0.004300047778308648,0.019294117647058823,0.08956602031394276,0.03822055137844611,0.036885245901639344,0.1680327868852459,0.7950819672131147
Zip,6824,Connecticut,NA,2450,3851,4902,11203,273,825,1140,2238,113175213,461434615,1316748179,1891358007,692102.5,0.11142857142857143,0.21423007011165932,0.23255813953488372,0.1997679193073284,0.12198391420911528,0.36863270777479895,0.5093833780160858
Zip,6853,Connecticut,NA,2,7,1401,1410,1,0,296,297,339354,0,567634215,567973569,1700770,0.5,0,0.21127765881513205,0.21063829787234042,0.003367003367003367,0,0.9966329966329966
Zip,6854,Connecticut,NA,2825,1815,1146,5786,165,81,258,504,40277279,33885077,248491748,322654104,521233.5,0.0584070796460177,0.04462809917355372,0.225130890052356,0.08710680954026961,0.3273809523809524,0.16071428571428573,0.5119047619047619
Zip,6855,Connecticut,NA,576,682,738,1996,4,8,180,192,1588576,3627379,234623331,239839286,855289.5,0.006944444444444444,0.011730205278592375,0.24390243902439024,0.09619238476953908,0.020833333333333332,0.041666666666666664,0.9375
Zip,6870,Connecticut,NA,534,830,696,2060,0,82,163,245,0,117774331,622835580,740609911,2703533,0,0.09879518072289156,0.23419540229885058,0.11893203883495146,0,0.3346938775510204,0.6653061224489796
Zip,6880,Connecticut,NA,3106,3160,3289,9555,131,203,445,779,85714677,238395669,1170869565,1494979911,1588708,0.042176432710882165,0.06424050632911392,0.13529948312557008,0.0815279958137101,0.1681643132220796,0.2605905006418485,0.5712451861360719
Zip,6902,Connecticut,NA,6347,3977,3529,13853,364,415,385,1164,106183817,194162089,522418379,822764285,461021.5,0.05734992910036238,0.10435001257229067,0.10909606120714083,0.08402512091243775,0.3127147766323024,0.35652920962199314,0.33075601374570446
Zip,7020,New Jersey,NA,1124,1129,1219,3472,173,161,92,426,65616646,86498901,72306681,224422228,488421,0.15391459074733096,0.14260407440212577,0.07547169811320754,0.12269585253456221,0.4061032863849765,0.3779342723004695,0.215962441314554
Zip,7030,New Jersey,NA,4215,4235,4237,12687,3030,3131,2065,8226,1504208520,2353807234,2595314588,6453330342,725938.5,0.7188612099644128,0.7393152302243211,0.48737314137361343,0.6483802317332703,0.36834427425237054,0.38062241672744956,0.2510333090201799
Zip,7032,New Jersey,NA,2379,2383,2378,7140,76,34,48,158,20285273,10804756,19309945,50399974,296461.5,0.031946195880622114,0.014267729752412925,0.020185029436501262,0.022128851540616248,0.4810126582278481,0.21518987341772153,0.3037974683544304
Zip,7047,New Jersey,NA,3456,3482,3483,10421,18,13,186,217,5163382,4764591,121955942,131883915,593694,0.005208333333333333,0.003733486502010339,0.053402239448751075,0.02082333749160349,0.08294930875576037,0.059907834101382486,0.8571428571428571
Zip,7074,New Jersey,NA,190,206,205,601,190,205,203,598,79361334,115246128,143291196,337898658,569906.5,1,0.9951456310679612,0.9902439024390244,0.9950083194675541,0.3177257525083612,0.342809364548495,0.3394648829431438
Zip,7086,New Jersey,NA,615,1019,991,2625,108,365,329,802,57032240,300112165,455914584,813058989,873506,0.17560975609756097,0.35819430814524045,0.33198789101917253,0.30552380952380953,0.13466334164588528,0.4551122194513716,0.4102244389027431
Zip,7094,New Jersey,NA,1583,1586,1587,4756,1103,537,458,2098,354087414,232884431,277046340,864018185,391882.5,0.6967782691092862,0.3385876418663304,0.2885948330182735,0.44112699747687134,0.5257387988560533,0.2559580552907531,0.21830314585319352
Zip,7095,New Jersey,NA,2790,1419,1044,5253,53,50,16,119,12539057,13337348,4906217,30782622,258429,0.01899641577060932,0.035236081747709654,0.01532567049808429,0.022653721682847898,0.44537815126050423,0.42016806722689076,0.13445378151260504
Zip,7105,New Jersey,NA,210,779,3590,4579,24,72,294,390,4337575,17655589,105845763,127838927,319777,0.11428571428571428,0.09242618741976893,0.0818941504178273,0.08517143481109413,0.06153846153846154,0.18461538461538463,0.7538461538461538
Zip,7202,New Jersey,NA,1210,2147,1015,4372,77,35,5,117,15503460,8947659,2295871,26746990,225894,0.06363636363636363,0.016301816488122962,0.0049261083743842365,0.0267612076852699,0.6581196581196581,0.29914529914529914,0.042735042735042736
Zip,7302,New Jersey,NA,211,681,9885,10777,16,191,2726,2933,4410102,79176073,2479904137,2563490312,806774,0.07582938388625593,0.28046989720998533,0.2757713707637835,0.2721536605734434,0.005455165359699966,0.06512103648141834,0.9294237981588817
Zip,7304,New Jersey,NA,3456,2619,363,6438,15,149,9,173,3945543,55213869,4908947,64068359,370815,0.004340277777777778,0.056891943489881636,0.024793388429752067,0.02687169928549239,0.08670520231213873,0.861271676300578,0.05202312138728324
Zip,7310,New Jersey,NA,2,23,1512,1537,2,13,1103,1118,502165,5428620,813762260,819693045,727756.5,1,0.5652173913043478,0.7294973544973545,0.7273910214703969,0.0017889087656529517,0.011627906976744186,0.9865831842576028
Zip,7601,New Jersey,NA,2703,2705,2661,8069,105,155,109,369,23192691,48501194,46934256,118628141,313775,0.038845726970033294,0.05730129390018484,0.040962044344231494,0.045730573800966665,0.2845528455284553,0.42005420054200543,0.2953929539295393
Zip,7605,New Jersey,NA,806,811,800,2417,99,25,6,130,31704303,13023231,3913628,48641162,388420.5,0.1228287841191067,0.030826140567200986,0.0075,0.05378568473314026,0.7615384615384615,0.19230769230769232,0.046153846153846156
Zip,7606,New Jersey,NA,165,171,178,514,40,54,62,156,14147113,23054231,34412553,71613897,437593,0.24242424242424243,0.3157894736842105,0.34831460674157305,0.3035019455252918,0.2564102564102564,0.34615384615384615,0.3974358974358974
Zip,7631,New Jersey,NA,2240,2322,2234,6796,274,265,12,551,76311116,103222758,5825202,185359076,340194,0.12232142857142857,0.11412575366063739,0.005371530886302597,0.08107710417892879,0.49727767695099817,0.4809437386569873,0.021778584392014518
Zip,7643,New Jersey,NA,749,738,731,2218,432,650,656,1738,112136362,218469881,298442060,629048303,345584,0.5767690253671562,0.8807588075880759,0.8974008207934336,0.7835888187556357,0.24856156501726123,0.3739930955120829,0.37744533947065595
Zip,7660,New Jersey,NA,949,938,936,2823,114,54,59,227,33602050,18332491,24594153,76528694,325027,0.12012644889357219,0.057569296375266525,0.06303418803418803,0.08041091037902941,0.5022026431718062,0.23788546255506607,0.2599118942731278
Zip,7717,New Jersey,NA,325,332,341,998,0,44,67,111,0,37824337,102071583,139895920,1158587,0,0.13253012048192772,0.19648093841642228,0.11122244488977956,0,0.3963963963963964,0.6036036036036037
Zip,7718,New Jersey,NA,1158,884,153,2195,70,43,9,122,20065125,15975949,4890091,40931165,316166,0.06044905008635579,0.048642533936651584,0.058823529411764705,0.05558086560364465,0.5737704918032787,0.3524590163934426,0.07377049180327869
Zip,7732,New Jersey,NA,1506,405,210,2121,668,118,61,847,138517964,44527259,42284994,225330217,230122,0.4435590969455511,0.291358024691358,0.2904761904761905,0.39933993399339934,0.7886658795749705,0.13931523022432113,0.07201889020070838
Zip,7734,New Jersey,NA,1773,1070,975,3818,988,740,580,2308,147046717,129414552,149345866,425807135,164965,0.5572476029328821,0.6915887850467289,0.5948717948717949,0.6045049764274489,0.42807625649913345,0.32062391681109187,0.2512998266897747
Zip,7735,New Jersey,NA,1920,2192,2021,6133,215,177,269,661,41085813,43554237,94152596,178792646,250020,0.11197916666666667,0.08074817518248176,0.13310242454230578,0.10777759660851133,0.32526475037821484,0.26777609682299547,0.4069591527987897
Zip,7739,New Jersey,NA,762,763,766,2291,4,35,172,211,1754295,22400477,260367362,284522134,1216009,0.005249343832020997,0.045871559633027525,0.2245430809399478,0.092099519860323,0.018957345971563982,0.16587677725118483,0.8151658767772512
Zip,7740,New Jersey,NA,2560,2530,2542,7632,262,264,203,729,65494518,96186476,141249245,302930239,342502,0.10234375,0.10434782608695652,0.07985837922895359,0.09551886792452831,0.35939643347050754,0.36213991769547327,0.2784636488340192
Zip,7748,New Jersey,NA,2150,3355,3639,9144,996,100,45,1141,222324203,36281898,27242559,285848660,232646,0.46325581395348836,0.029806259314456036,0.01236603462489695,0.12478127734033245,0.8729184925503944,0.0876424189307625,0.03943908851884312
Zip,7750,New Jersey,NA,657,649,697,2003,295,211,471,977,92178134,140858454,603363645,836400233,797962,0.4490106544901065,0.325115562403698,0.6757532281205165,0.48776834747878184,0.30194472876151485,0.21596724667349027,0.4820880245649949
Zip,7753,New Jersey,NA,4531,4554,2675,11760,8,139,110,257,2021805,39694863,45681537,87398205,320939,0.0017656146546016333,0.03052261747913922,0.041121495327102804,0.02185374149659864,0.0311284046692607,0.5408560311284046,0.4280155642023346
Zip,7757,New Jersey,NA,549,727,741,2017,76,176,292,544,27544978,80664706,296870398,405080082,555093.5,0.1384335154826958,0.24209078404401652,0.3940620782726046,0.2697074863658899,0.13970588235294118,0.3235294117647059,0.5367647058823529
Zip,7758,New Jersey,NA,984,586,144,1714,388,138,11,537,97871964,54176853,5554136,157602953,284279,0.3943089430894309,0.2354948805460751,0.0763888888888889,0.31330221703617267,0.7225325884543762,0.2569832402234637,0.020484171322160148
Zip,7760,New Jersey,NA,1148,1179,1448,3775,325,421,405,1151,127027226,308972735,662253282,1098253243,740378,0.28310104529616725,0.3570822731128075,0.2796961325966851,0.30490066225165563,0.28236316246741966,0.365768896611642,0.3518679409209383
Zip,8005,New Jersey,NA,3095,3158,2898,9151,151,405,352,908,28001459,114890067,163056206,305947732,303212,0.04878836833602585,0.12824572514249524,0.12146307798481712,0.0992241285105453,0.16629955947136563,0.4460352422907489,0.3876651982378855
Zip,8006,New Jersey,NA,266,294,621,1181,247,230,445,922,139082217,186779892,417227919,743090028,780921,0.9285714285714286,0.782312925170068,0.71658615136876,0.7806943268416596,0.2678958785249458,0.24945770065075923,0.482646420824295
Zip,8008,New Jersey,NA,4390,4457,6594,15441,4097,3896,4772,12765,2263851003,3064297441,6215845035,11543993479,775672,0.933257403189066,0.8741305811083688,0.7236882013952077,0.8266951622304255,0.3209557383470427,0.30520955738347044,0.3738347042694869
Zip,8016,New Jersey,NA,3494,3437,3461,10392,1615,367,64,2046,204396155,69319078,22103119,295818352,134209.5,0.46222095020034343,0.10677916787896422,0.01849176538572667,0.19688221709006928,0.7893450635386119,0.17937438905180841,0.03128054740957967
Zip,8027,New Jersey,NA,614,622,619,1855,150,220,233,603,21454473,37288262,51391530,110134265,171835,0.24429967426710097,0.3536977491961415,0.3764135702746365,0.32506738544474395,0.24875621890547264,0.3648424543946932,0.3864013266998342
Zip,8030,New Jersey,NA,1476,1475,1417,4368,91,51,67,209,6613975,5745856,10813959,23173790,104369,0.061653116531165314,0.03457627118644068,0.04728299223712068,0.047847985347985345,0.4354066985645933,0.24401913875598086,0.32057416267942584
Zip,8037,New Jersey,NA,2371,3146,2474,7991,50,57,102,209,6761041,9598644,29200186,45559871,191576,0.021088148460565163,0.018118245390972662,0.041228779304769606,0.02615442372669253,0.23923444976076555,0.2727272727272727,0.4880382775119617
Zip,8050,New Jersey,NA,3957,3866,4116,11939,1340,1312,1443,4095,327748651,443884345,704187770,1475820766,335922,0.33864038412939096,0.33936885669943095,0.35058309037900875,0.3429935505486222,0.32722832722832723,0.3203907203907204,0.3523809523809524
Zip,8063,New Jersey,NA,401,382,363,1146,63,46,70,179,7439214,6511888,12572549,26523651,144563,0.1571072319201995,0.12041884816753927,0.1928374655647383,0.156195462478185,0.35195530726256985,0.2569832402234637,0.39106145251396646
Zip,8065,New Jersey,NA,941,935,912,2788,249,136,71,456,31157904,21790576,13067765,66016245,143846,0.26461211477151964,0.14545454545454545,0.07785087719298246,0.16355810616929697,0.5460526315789473,0.2982456140350877,0.15570175438596492
Zip,8066,New Jersey,NA,784,681,809,2274,150,81,70,301,15133742,10183395,10571701,35888838,115383,0.1913265306122449,0.11894273127753303,0.0865265760197775,0.13236587510993844,0.4983388704318937,0.2691029900332226,0.23255813953488372
Zip,8069,New Jersey,NA,1311,1293,1287,3891,409,339,289,1037,33761287,38631315,43761297,116153899,102949,0.3119755911517925,0.26218097447795824,0.22455322455322455,0.2665124646620406,0.3944069431051109,0.32690453230472516,0.2786885245901639
Zip,8070,New Jersey,NA,1500,1534,1529,4563,858,784,798,2440,88211670,109890351,150565980,348668001,136587,0.572,0.5110821382007823,0.5219097449313277,0.5347359193513039,0.3516393442622951,0.32131147540983607,0.32704918032786884
Zip,8075,New Jersey,NA,3125,3140,3043,9308,161,93,95,349,23517959,15149941,25364787,64032687,158070,0.05152,0.02961783439490446,0.031219191587249426,0.03749462827675118,0.46131805157593125,0.2664756446991404,0.2722063037249284
Zip,8077,New Jersey,NA,2171,2239,2222,6632,242,47,30,319,43089005,11870777,11372570,66332352,186944,0.11146936895439889,0.020991514068780706,0.013501350135013501,0.04810012062726176,0.7586206896551724,0.14733542319749215,0.09404388714733543
Zip,8079,New Jersey,NA,1207,1217,1134,3558,531,496,476,1503,46842228,56263185,81049541,184154954,102220,0.43993371996686,0.4075595727198028,0.41975308641975306,0.42242833052276557,0.3532934131736527,0.3300066533599468,0.3166999334664005
Zip,8085,New Jersey,NA,1987,2013,2214,6214,53,23,59,135,8576467,4657429,21921463,35155359,223703,0.026673376950176145,0.011425732737208148,0.026648599819331528,0.021725136787898294,0.3925925925925926,0.17037037037037037,0.43703703703703706
Zip,8086,New Jersey,NA,810,803,1060,2673,82,50,15,147,12404831,9182495,3876323,25463649,164263,0.10123456790123457,0.062266500622665005,0.014150943396226415,0.05499438832772166,0.5578231292517006,0.3401360544217687,0.10204081632653061
Zip,8087,New Jersey,NA,4114,4110,4152,12376,1135,1574,1904,4613,157766612,281572083,577672120,1017010815,195609,0.27588721438988817,0.3829683698296837,0.45857418111753373,0.372737556561086,0.24604378929113374,0.3412096249729027,0.41274658573596357
Zip,8092,New Jersey,NA,448,570,360,1378,120,69,55,244,20149048,17312324,22025954,59487326,210056,0.26785714285714285,0.12105263157894737,0.1527777777777778,0.17706821480406387,0.4918032786885246,0.2827868852459016,0.22540983606557377
Zip,8103,New Jersey,NA,1802,1692,1550,5044,174,137,141,452,10646834,10477654,14611008,35735496,76279.5,0.09655937846836848,0.08096926713947991,0.09096774193548388,0.08961141950832673,0.38495575221238937,0.3030973451327434,0.31194690265486724
Zip,8104,New Jersey,NA,3821,2468,496,6785,508,177,31,716,31845080,13146684,3208040,48199804,65688.5,0.13294948966239203,0.07171799027552674,0.0625,0.10552689756816507,0.7094972067039106,0.24720670391061453,0.04329608938547486
Zip,8105,New Jersey,NA,1072,2076,3775,6923,215,310,279,804,14223134,22881824,26541803,63646761,74941,0.20055970149253732,0.14932562620423892,0.07390728476821191,0.11613462371804131,0.26741293532338306,0.3855721393034826,0.34701492537313433
Zip,8107,New Jersey,NA,1801,1107,953,3861,140,84,42,266,14943994,8319243,5347808,28611045,84860.5,0.07773459189339256,0.07588075880758807,0.04407135362014691,0.06889406889406889,0.5263157894736842,0.3157894736842105,0.15789473684210525
Zip,8201,New Jersey,NA,1103,1104,1134,3341,42,56,68,166,5390016,9542595,19322906,34255517,180829.5,0.038077969174977334,0.050724637681159424,0.059964726631393295,0.04968572283747381,0.25301204819277107,0.3373493975903614,0.40963855421686746
Zip,8202,New Jersey,NA,1784,1786,1981,5551,1674,1620,1597,4891,1094311608,2076095998,3749786220,6920193826,1142197,0.9383408071748879,0.9070548712206047,0.8061585058051489,0.8811025040533237,0.3422612962584339,0.33122060928235536,0.3265180944592108
Zip,8203,New Jersey,NA,2844,2850,2853,8547,1296,1784,1779,4859,307353546,557393785,1037538162,1902285493,313884,0.45569620253164556,0.6259649122807017,0.6235541535226078,0.5685035685035685,0.26672154764354805,0.367153735336489,0.36612471701996296
Zip,8204,New Jersey,NA,3784,3708,3696,11188,532,792,1117,2441,183779293,425421706,1093422087,1702623086,584957,0.14059196617336153,0.21359223300970873,0.3022186147186147,0.21818019306399714,0.2179434657927079,0.32445718967636217,0.45759934453092993
Zip,8205,New Jersey,NA,4135,3754,3564,11453,62,56,28,146,11513786,10847323,6622744,28983853,205880,0.014993954050785973,0.014917421417155035,0.007856341189674524,0.012747751680782328,0.4246575342465753,0.3835616438356164,0.1917808219178082
Zip,8210,New Jersey,NA,2043,2699,2752,7494,464,217,340,1021,73913916,53701266,200771290,328386472,230440,0.22711698482623593,0.08040014820303816,0.12354651162790697,0.1362423271950894,0.4544564152791381,0.21253672869735554,0.3330068560235064
Zip,8212,New Jersey,NA,8,11,315,334,8,9,266,283,4363905,5747186,206147684,216258775,714428,1,0.8181818181818182,0.8444444444444444,0.8473053892215568,0.028268551236749116,0.03180212014134275,0.9399293286219081
Zip,8221,New Jersey,NA,844,872,872,2588,61,74,69,204,11336438,18308208,38698348,68342994,246969,0.07227488151658767,0.08486238532110092,0.07912844036697247,0.07882534775888717,0.29901960784313725,0.3627450980392157,0.3382352941176471
Zip,8223,New Jersey,NA,707,667,534,1908,138,24,36,198,28511577,6813185,32237635,67562397,195685,0.19519094766619519,0.035982008995502246,0.06741573033707865,0.10377358490566038,0.696969696969697,0.12121212121212122,0.18181818181818182
Zip,8225,New Jersey,NA,1123,1007,1007,3137,119,3,12,134,11124155,607289,3536041,15267485,96788,0.10596616206589493,0.0029791459781529296,0.011916583912611719,0.04271597067261715,0.8880597014925373,0.022388059701492536,0.08955223880597014
Zip,8226,New Jersey,NA,3955,4093,4141,12189,3268,3441,2940,9649,1086065598,1900998267,3512952556,6500016421,535266,0.8262958280657395,0.840703640361593,0.709973436368027,0.791615390926245,0.3386879469375065,0.35661726603793137,0.30469478702456215
Zip,8232,New Jersey,NA,1761,1715,1607,5083,191,153,115,459,20798957,25199681,26865785,72864423,134510,0.1084611016467916,0.0892128279883382,0.0715619166148102,0.0903010033444816,0.41612200435729846,0.3333333333333333,0.25054466230936817
Zip,8234,New Jersey,NA,4696,4873,4746,14315,113,203,150,466,17007974,41812974,45946762,104767710,215258.5,0.024063032367972744,0.041658116150215474,0.0316055625790139,0.03255326580509955,0.24248927038626608,0.4356223175965665,0.3218884120171674
Zip,8243,New Jersey,NA,2134,2132,2132,6398,1973,2026,1713,5712,870577129,1390690837,1729458941,3990726907,681854,0.9245548266166823,0.950281425891182,0.8034709193245778,0.8927789934354485,0.34541316526610644,0.3546918767507003,0.29989495798319327
Zip,8244,New Jersey,NA,1250,1277,1317,3844,197,357,520,1074,30351817,67920859,188915798,287188474,213686.5,0.1576,0.27956147220046984,0.39483675018982534,0.2793964620187305,0.18342644320297952,0.3324022346368715,0.48417132216014896
Zip,8247,New Jersey,NA,967,978,1084,3029,846,838,657,2341,533710733,1141050943,1530120884,3204882560,1110928,0.8748707342295761,0.8568507157464212,0.6060885608856088,0.772862330802245,0.3613840239214011,0.3579666809055959,0.28064929517300297
Zip,8248,New Jersey,NA,115,120,128,363,115,119,112,346,64359998,103311962,143768855,311440815,877741,1,0.9916666666666667,0.875,0.953168044077135,0.33236994219653176,0.3439306358381503,0.3236994219653179
Zip,8251,New Jersey,NA,2374,2001,1896,6271,957,641,467,2065,143167973,115730138,171904649,430802760,162426,0.403117101937658,0.32033983008495753,0.24630801687763712,0.32929357359272843,0.4634382566585956,0.31041162227602903,0.2261501210653753
Zip,8260,New Jersey,NA,6632,6372,6447,19451,5330,5716,5409,16455,1081733932,1752006054,2638679962,5472419948,292354,0.8036791314837153,0.8970495919648462,0.8389948813401582,0.8459719294637807,0.3239137040413248,0.3473716195685202,0.32871467639015495
Zip,8270,New Jersey,NA,1180,1004,938,3122,66,88,106,260,14568996,22820690,46468622,83858308,268377,0.05593220338983051,0.08764940239043825,0.11300639658848614,0.08327994875080078,0.25384615384615383,0.3384615384615385,0.4076923076923077
Zip,8302,New Jersey,NA,3855,4178,3815,11848,77,21,39,137,7323880,2763291,8931112,19018283,116326,0.019974059662775615,0.005026328386787937,0.010222804718217562,0.011563133018230925,0.5620437956204379,0.15328467153284672,0.2846715328467153
Zip,8321,New Jersey,NA,159,53,34,246,100,47,31,178,10670271,6593810,5894980,23159061,123228,0.6289308176100629,0.8867924528301887,0.9117647058823529,0.7235772357723578,0.5617977528089888,0.2640449438202247,0.17415730337078653
Zip,8330,New Jersey,NA,3251,2957,3078,9286,41,24,79,144,5331514,3866834,25335652,34534e3,193802,0.012611504152568441,0.008116334122421373,0.025666016894087068,0.015507215162610381,0.2847222222222222,0.16666666666666666,0.5486111111111112
Zip,8332,New Jersey,NA,3729,3809,3893,11431,93,34,66,193,8116050,5054518,17378975,30549543,136779,0.0249396621078037,0.008926227356261486,0.016953506293347034,0.01688391216866416,0.48186528497409326,0.17616580310880828,0.34196891191709844
Zip,8345,New Jersey,NA,124,161,216,501,76,104,162,342,8523463,14903449,32060959,55487871,154744.5,0.6129032258064516,0.6459627329192547,0.75,0.6826347305389222,0.2222222222222222,0.30409356725146197,0.47368421052631576
Zip,8349,New Jersey,NA,327,332,276,935,138,132,103,373,14550146,17605737,17553664,49709547,129876,0.42201834862385323,0.39759036144578314,0.37318840579710144,0.39893048128342246,0.3699731903485255,0.353887399463807,0.2761394101876676
Zip,8401,New Jersey,NA,3482,3493,3454,10429,2795,2594,2234,7623,241110174,328972921,562668367,1132751462,120290,0.8026995979322229,0.7426281133695963,0.6467863346844238,0.730942564004219,0.3666535484717303,0.340285976649613,0.2930604748786567
Zip,8402,New Jersey,NA,2164,2161,2190,6515,1974,1902,1917,5793,616699196,925353711,1966002254,3508055161,481229,0.9121996303142329,0.8801480795927811,0.8753424657534247,0.8891788181120491,0.340756084930088,0.3283272915587778,0.3309166235111341
Zip,8403,New Jersey,NA,521,527,629,1677,521,505,566,1592,276284876,413739448,1166470079,1856494403,744850,1,0.9582542694497154,0.8998410174880763,0.9493142516398331,0.32726130653266333,0.31721105527638194,0.3555276381909548
Zip,8406,New Jersey,NA,1997,1964,1990,5951,1629,1766,874,4269,275951720,469460287,434281319,1179693326,239964,0.8157235853780671,0.8991853360488798,0.4391959798994975,0.7173584271551,0.38158819395643007,0.4136800187397517,0.20473178730381822
Zip,8721,New Jersey,NA,167,1900,5880,7947,49,217,2023,2289,6755096,42539218,879969295,929263609,358823,0.2934131736526946,0.11421052631578947,0.34404761904761905,0.2880332200830502,0.021406727828746176,0.09480122324159021,0.8837920489296636
Zip,8723,New Jersey,NA,3896,4174,4308,12378,366,712,2416,3494,71551850,193546511,1238343395,1503441756,379338,0.09394250513347023,0.17057977958792525,0.5608170844939647,0.2822750040394248,0.10475100171722954,0.20377790497996565,0.6914710933028048
Zip,8724,New Jersey,NA,5768,5438,5317,16523,9,79,674,762,1836993,22300823,447780645,471918461,518862.5,0.0015603328710124826,0.014527399779330636,0.12676321233778445,0.04611753313562912,0.011811023622047244,0.1036745406824147,0.884514435695538
Zip,8730,New Jersey,NA,658,654,657,1969,49,63,97,209,21018197,38187933,164118268,223324398,664376,0.07446808510638298,0.0963302752293578,0.1476407914764079,0.10614525139664804,0.23444976076555024,0.3014354066985646,0.46411483253588515
Zip,8731,New Jersey,NA,3184,3073,2493,8750,497,645,1271,2413,86837025,168244306,589475229,844556560,315292,0.1560929648241206,0.20989261308167914,0.5098275170477337,0.27577142857142856,0.20596767509324493,0.2673021135515955,0.5267302113551595
Zip,8734,New Jersey,NA,673,798,1376,2847,234,258,461,953,46095086,68403281,236276491,350774858,308349,0.3476968796433878,0.3233082706766917,0.33502906976744184,0.3347383210396909,0.24554039874081846,0.2707240293809024,0.4837355718782791
Zip,8735,New Jersey,NA,2177,2189,2194,6560,1795,1960,1700,5455,593773471,1114308354,1743451636,3451533461,559711,0.8245291685806155,0.8953860210141618,0.7748404740200547,0.8315548780487805,0.3290559120073327,0.3593033913840513,0.31164069660861593
Zip,8736,New Jersey,NA,1390,1825,2138,5353,346,431,488,1265,160840101,269161302,447394366,877395769,655482,0.2489208633093525,0.23616438356164385,0.22825070159027128,0.23631608443863253,0.2735177865612648,0.34071146245059286,0.3857707509881423
Zip,8738,New Jersey,NA,159,196,1382,1737,158,186,966,1310,222081747,435681286,1328923666,1986686699,1202297.5,0.9937106918238994,0.9489795918367347,0.6989869753979739,0.7541738629821532,0.12061068702290076,0.14198473282442747,0.7374045801526717
Zip,8740,New Jersey,NA,339,359,354,1052,256,255,289,800,36500073,50733244,110627408,197860725,204474,0.7551622418879056,0.7103064066852368,0.8163841807909604,0.7604562737642585,0.32,0.31875,0.36125
Zip,8742,New Jersey,NA,3823,3836,4051,11710,1154,1424,2040,4618,507619331,914726022,1897143409,3319488762,559830.5,0.3018571802249542,0.37122002085505734,0.5035793631202172,0.39436379163108454,0.2498917280207882,0.30835859679514943,0.4417496751840624
Zip,8751,New Jersey,NA,1363,1368,1420,4151,1334,1270,1256,3860,274780356,396627787,662963412,1334371555,301438.5,0.9787234042553191,0.9283625730994152,0.8845070422535212,0.9298964105034931,0.3455958549222798,0.3290155440414508,0.32538860103626943
Zip,8752,New Jersey,NA,692,691,1770,3153,465,562,1128,2155,171042305,309637290,709240077,1189919672,531340,0.6719653179190751,0.8133140376266281,0.6372881355932203,0.6834760545512211,0.21577726218097448,0.2607888631090487,0.5234338747099768
Zip,8753,New Jersey,NA,8413,7777,7441,23631,1846,1217,2826,5889,362186669,334751131,1507209432,2204147232,306798,0.2194223225959824,0.15648707727915648,0.37978766294852845,0.24920655071727815,0.31346578366445915,0.206656478179657,0.47987773815588386
Zip,8758,New Jersey,NA,1270,1144,1389,3803,395,429,255,1079,75440972,126765840,135892736,338099548,283271,0.3110236220472441,0.375,0.183585313174946,0.2837233762818827,0.366079703429101,0.39759036144578314,0.23632993512511585
Zip,8872,New Jersey,NA,1770,1588,1700,5058,27,89,17,133,6590934,26995369,6138313,39724616,299657,0.015254237288135594,0.05604534005037783,0.01,0.026294978252273626,0.20300751879699247,0.6691729323308271,0.12781954887218044
Zip,8882,New Jersey,NA,1488,1482,1442,4412,90,30,14,134,19187866,7895374,4599014,31682254,233256.5,0.06048387096774194,0.020242914979757085,0.009708737864077669,0.030371713508612876,0.6716417910447762,0.22388059701492538,0.1044776119402985
Zip,10004,New York,NA,1,286,980,1267,1,185,201,387,570490,138288474,520327265,659186229,1126341,1,0.6468531468531469,0.20510204081632652,0.30544593528018943,0.002583979328165375,0.4780361757105943,0.5193798449612403
Zip,10005,New York,NA,3,368,1217,1588,0,44,72,116,0,32976462,125572940,158549402,1328520.5,0,0.11956521739130435,0.05916187345932621,0.07304785894206549,0,0.3793103448275862,0.6206896551724138
Zip,10006,New York,NA,0,388,338,726,0,4,138,142,0,3241718,289633338,292875056,1545676.5,0,0.010309278350515464,0.40828402366863903,0.19559228650137742,0,0.028169014084507043,0.971830985915493
Zip,10007,New York,NA,1,53,1377,1431,0,0,285,285,0,0,682741941,682741941,2033805,0,0,0.20697167755991286,0.19916142557651992,0,0,1
Zip,10009,New York,NA,3,256,784,1043,1,53,191,245,497696,40341401,1042585698,1083424795,1556215,0.3333333333333333,0.20703125,0.24362244897959184,0.2348993288590604,0.004081632653061225,0.2163265306122449,0.7795918367346939
Zip,10011,New York,NA,33,641,4868,5542,0,85,422,507,0,69443360,1361656554,1431099914,1158119,0,0.13260530421216848,0.08668857847165161,0.09148321905449296,0,0.16765285996055226,0.8323471400394478
Zip,10013,New York,NA,0,580,4009,4589,0,0,475,475,0,0,2600543132,2600543132,4800421,0,0,0.11848341232227488,0.1035083896273698,0,0,1
Zip,10014,New York,NA,0,230,2945,3175,0,0,290,290,0,0,1552823765,1552823765,3249683,0,0,0.09847198641765705,0.09133858267716535,0,0,1
Zip,10016,New York,NA,310,2358,5332,8e3,0,302,355,657,0,260646187,485749624,746395811,1142960,0,0.1280746395250212,0.06657914478619655,0.082125,0,0.4596651445966514,0.5403348554033486
Zip,10306,New York,NA,10535,4221,498,15254,828,57,2,887,352507955,37385474,1645313,391538742,439884,0.07859515899383009,0.013503909026297086,0.004016064257028112,0.05814868231283598,0.9334836527621195,0.06426155580608793,0.002254791431792559
Zip,10308,New York,NA,5770,2206,65,8041,162,28,0,190,71991483,19999276,0,91990759,475185.5,0.028076256499133447,0.012692656391659111,0,0.023628901877875887,0.8526315789473684,0.14736842105263157,0
Zip,10464,New York,NA,862,357,97,1316,76,22,15,113,35587188,16136383,17199493,68923064,503967,0.08816705336426914,0.06162464985994398,0.15463917525773196,0.0858662613981763,0.672566371681416,0.19469026548672566,0.13274336283185842
Zip,10465,New York,NA,5397,2148,169,7714,295,97,27,419,123619517,68275719,31169291,223064527,461731,0.05465999629423754,0.04515828677839851,0.15976331360946747,0.05431682654913145,0.7040572792362768,0.2315035799522673,0.06443914081145585
Zip,10473,New York,NA,4562,518,14,5094,332,7,1,340,130497530,4534378,1015751,136047659,388438,0.07277509864094696,0.013513513513513514,0.07142857142857142,0.06674519042010207,0.9764705882352941,0.020588235294117647,0.0029411764705882353
Zip,10580,New York,NA,1440,1463,1495,4398,50,22,45,117,53551008,43375448,247744377,344670833,1768101,0.034722222222222224,0.015037593984962405,0.030100334448160536,0.02660300136425648,0.42735042735042733,0.18803418803418803,0.38461538461538464
Zip,11096,New York,NA,446,439,429,1314,105,83,78,266,39428174,39559873,50367693,129355740,468599.5,0.23542600896860988,0.18906605922551253,0.18181818181818182,0.2024353120243531,0.39473684210526316,0.31203007518796994,0.2932330827067669
Zip,11101,New York,NA,187,1146,1628,2961,6,130,221,357,3360389,98355604,273527142,375243135,1010519,0.03208556149732621,0.11343804537521815,0.13574938574938575,0.12056737588652482,0.01680672268907563,0.3641456582633053,0.6190476190476191
Zip,11201,New York,NA,170,1259,5116,6545,0,4,128,132,0,2468497,304534068,307002565,2091972,0,0.003177124702144559,0.02501954652071931,0.020168067226890758,0,0.030303030303030304,0.9696969696969697
Zip,11224,New York,NA,1889,525,563,2977,1610,246,160,2016,809903737,173926423,188648430,1172478590,522298,0.8523028057173108,0.4685714285714286,0.2841918294849023,0.6771918038293584,0.7986111111111112,0.12202380952380952,0.07936507936507936
Zip,11229,New York,NA,2107,6427,2609,11143,1063,104,9,1176,495532297,73372648,8277457,577182402,484924,0.5045087802562885,0.016181733312587522,0.0034495975469528554,0.10553710849860899,0.9039115646258503,0.08843537414965986,0.007653061224489796
Zip,11231,New York,NA,19,637,3951,4607,0,10,260,270,0,7918090,572266038,580184128,2008032.5,0,0.015698587127158554,0.06580612503163756,0.05860646841762535,0,0.037037037037037035,0.9629629629629629
Zip,11234,New York,NA,6907,10335,1153,18395,0,70,53,123,0,52855816,86612805,139468621,871119,0,0.006773101112723754,0.04596704249783174,0.0066865996194618105,0,0.5691056910569106,0.43089430894308944
Zip,11235,New York,NA,1616,5126,2516,9258,1072,1494,1307,3873,500941022,1135327990,2079522793,3715791805,796825,0.6633663366336634,0.29145532579008976,0.5194753577106518,0.4183408943616332,0.27678801962303123,0.38574748257164987,0.3374644978053189
Zip,11236,New York,NA,7279,6687,47,14013,1265,977,0,2242,592326471,636751361,0,1229077832,569186,0.1737876081879379,0.14610438163601017,0,0.15999429101548562,0.564228367528992,0.43577163247100803,0
Zip,11414,New York,NA,1830,4072,101,6003,792,1709,29,2530,365697488,1202307873,32440626,1600445987,670921.5,0.43278688524590164,0.41969548133595286,0.2871287128712871,0.421455938697318,0.3130434782608696,0.675494071146245,0.011462450592885375
Zip,11422,New York,NA,4930,1324,25,6279,477,312,6,795,227013341,204591298,4061862,435666501,535631,0.09675456389452333,0.23564954682779457,0.24,0.12661251791686573,0.6,0.39245283018867927,0.007547169811320755
Zip,11509,New York,NA,388,396,413,1197,88,30,61,179,47074989,27853215,129705300,204633504,783800,0.2268041237113402,0.07575757575757576,0.14769975786924938,0.14954051796157058,0.49162011173184356,0.16759776536312848,0.3407821229050279
Zip,11510,New York,NA,3193,3196,3144,9533,349,501,836,1686,123468434,213681838,472575344,809725616,446565.5,0.10930159724397119,0.1567584480600751,0.26590330788804073,0.17685933074583027,0.2069988137603796,0.297153024911032,0.4958481613285884
Zip,11516,New York,NA,581,570,564,1715,196,148,124,468,110275419,106261859,111249284,327786562,704768,0.3373493975903614,0.2596491228070175,0.2198581560283688,0.27288629737609327,0.4188034188034188,0.3162393162393162,0.26495726495726496
Zip,11518,New York,NA,1025,1e3,1039,3064,628,288,412,1328,229291895,146543495,291050078,666885468,470908.5,0.6126829268292683,0.288,0.3965351299326275,0.43342036553524804,0.47289156626506024,0.21686746987951808,0.3102409638554217
Zip,11520,New York,NA,2992,3010,2902,8904,1050,1318,1062,3430,323180096,479912160,546423339,1349515595,361608,0.35093582887700536,0.4378737541528239,0.36595451412818747,0.38522012578616355,0.30612244897959184,0.38425655976676387,0.30962099125364434
Zip,11557,New York,NA,762,702,806,2270,184,108,85,377,134222458,112543632,157559856,404325946,811958,0.24146981627296588,0.15384615384615385,0.1054590570719603,0.166079295154185,0.4880636604774536,0.2864721485411141,0.22546419098143236
Zip,11558,New York,NA,786,781,771,2338,714,700,725,2139,271191420,329037605,515726891,1115955916,471271,0.9083969465648855,0.8962868117797695,0.940337224383917,0.9148845166809239,0.3338008415147265,0.32725572697522204,0.3389434315100514
Zip,11559,New York,NA,675,730,738,2143,164,138,93,395,100981885,160459087,194939411,456380383,1065320,0.24296296296296296,0.18904109589041096,0.12601626016260162,0.1843210452636491,0.4151898734177215,0.3493670886075949,0.23544303797468355
Zip,11561,New York,NA,3253,3287,3197,9737,2195,1992,1778,5965,945656097,1140651534,1514492169,3600799800,561706,0.6747617583768829,0.6060237298448433,0.5561463872380357,0.6126116873780425,0.36797988264878456,0.3339480301760268,0.2980720871751886
Zip,11566,New York,NA,3803,3814,3834,11451,330,481,1018,1829,145018865,263817289,853949039,1262785193,618920,0.08677359978963976,0.12611431567907708,0.2655190401669275,0.15972404156842196,0.18042646254784034,0.2629852378348824,0.5565882996172772
Zip,11569,New York,NA,260,267,279,806,113,111,85,309,65353872,83621230,95441068,244416170,737293,0.4346153846153846,0.4157303370786517,0.3046594982078853,0.38337468982630274,0.3656957928802589,0.3592233009708738,0.2750809061488673
Zip,11572,New York,NA,3142,3128,3094,9364,1098,1258,1712,4068,444820895,620500684,1163642911,2228964490,505987,0.3494589433481859,0.40217391304347827,0.5533290239172592,0.43442973088423753,0.26991150442477874,0.30924287118977384,0.42084562438544737
Zip,11581,New York,NA,1577,1360,3021,5958,457,299,1665,2421,179112810,136499076,1129844387,1445456273,578499,0.2897907419150285,0.21985294117647058,0.551142005958292,0.40634441087613293,0.18876497315159024,0.1235026848409748,0.6877323420074349
Zip,11598,New York,NA,1116,1278,1263,3657,425,626,462,1513,282426427,485458959,515597396,1283482782,749063,0.38082437275985664,0.48982785602503914,0.3657957244655582,0.4137270987147936,0.2808988764044944,0.4137475214805023,0.3053536021150033
Zip,11691,New York,NA,4098,1202,218,5518,1834,371,13,2218,789413209,256409567,20415426,1066238202,450964.5,0.447535383113714,0.3086522462562396,0.05963302752293578,0.4019572308807539,0.8268710550045085,0.1672678088367899,0.005861136158701533
Zip,11692,New York,NA,1489,553,35,2077,1320,234,15,1569,568184816,157325565,21658607,747168988,436321,0.8865010073875084,0.4231464737793852,0.42857142857142855,0.7554164660568127,0.8413001912045889,0.1491395793499044,0.009560229445506692
Zip,11693,New York,NA,1531,258,25,1814,1412,214,2,1628,564764944,141358203,4581286,710704433,422961.5,0.922273024167211,0.8294573643410853,0.08,0.8974641675854466,0.8673218673218673,0.13144963144963145,0.0012285012285012285
Zip,11694,New York,NA,614,1983,1025,3622,343,1675,697,2715,141895806,1336758962,780371872,2259026640,835274,0.5586319218241043,0.8446797781139688,0.68,0.7495858641634456,0.1263351749539595,0.6169429097605893,0.2567219152854512
Zip,11701,New York,NA,2356,2182,2253,6791,73,494,1129,1696,18801665,169262767,570735386,758799818,417573,0.03098471986417657,0.22639780018331807,0.501109631602308,0.24974230599322633,0.04304245283018868,0.29127358490566035,0.6656839622641509
Zip,11702,New York,NA,1333,1428,2084,4845,364,453,1162,1979,146759910,221398516,890077051,1258235477,514106,0.2730682670667667,0.3172268907563025,0.5575815738963532,0.4084623323013416,0.1839312784234462,0.2289034866093987,0.5871652349671551
Zip,11704,New York,NA,3501,3450,3365,10316,28,4,128,160,9799611,1627396,61533826,72960833,384162,0.007997714938588975,0.0011594202898550724,0.03803863298662704,0.015509887553315239,0.175,0.025,0.8
Zip,11705,New York,NA,30,995,1285,2310,1,37,291,329,208517,16649200,202537837,219395554,543636,0.03333333333333333,0.0371859296482412,0.2264591439688716,0.14242424242424243,0.00303951367781155,0.11246200607902736,0.8844984802431611
Zip,11706,New York,NA,8834,3849,2948,15631,125,149,1305,1579,36888422,53745760,1185791721,1276425903,816110,0.014149875481095767,0.03871135359833723,0.4426729986431479,0.10101720939159363,0.07916402786573781,0.09436352121595946,0.8264724509183027
Zip,11709,New York,NA,785,786,780,2351,369,234,128,731,160155907,132011565,108978917,401146389,507292,0.47006369426751593,0.29770992366412213,0.1641025641025641,0.3109315185027648,0.5047879616963065,0.320109439124487,0.17510259917920656
Zip,11710,New York,NA,3583,3598,3586,10767,478,429,925,1832,198726460,215380011,654389569,1068496040,538217.5,0.13340775886128942,0.11923290717065037,0.25794757389849415,0.17014953097427324,0.2609170305676856,0.2341703056768559,0.5049126637554585
Zip,11715,New York,NA,534,537,588,1659,58,143,167,368,20033805,55763624,114254733,190052162,416723,0.10861423220973783,0.26629422718808193,0.28401360544217685,0.2218203737191079,0.15760869565217392,0.38858695652173914,0.453804347826087
Zip,11718,New York,NA,4,28,1046,1078,0,0,135,135,0,0,102243528,102243528,673513,0,0,0.12906309751434034,0.12523191094619665,0,0,1
Zip,11719,New York,NA,387,391,410,1188,81,42,94,217,25788609,15455124,73027236,114270969,365315,0.20930232558139536,0.10741687979539642,0.22926829268292684,0.18265993265993266,0.37327188940092165,0.1935483870967742,0.43317972350230416
Zip,11726,New York,NA,1538,1608,1481,4627,41,86,742,869,10255579,27261329,307471147,344988055,358201,0.026657997399219768,0.053482587064676616,0.5010128291694801,0.1878106764642317,0.047180667433831994,0.09896432681242807,0.85385500575374
Zip,11730,New York,NA,118,2505,1635,4258,0,2,163,165,0,2176785,202793957,204970742,1153551,0,7.984031936127744e-4,0.09969418960244648,0.03875058713010803,0,0.012121212121212121,0.9878787878787879
Zip,11751,New York,NA,408,2347,1327,4082,1,22,424,447,300429,8042653,316595334,324938416,596882,0.0024509803921568627,0.009373668512995313,0.31951770911831195,0.10950514453699167,0.0022371364653243847,0.049217002237136466,0.9485458612975392
Zip,11757,New York,NA,4218,4237,4225,12680,1666,607,971,3244,503305327,205790899,470911100,1180007326,328618,0.39497392128971076,0.14326174179844228,0.22982248520710058,0.2558359621451104,0.5135635018495684,0.18711467324290998,0.29932182490752157
Zip,11758,New York,NA,5667,5671,5811,17149,621,789,2538,3948,251150215,396802174,1900401949,2548354338,578043,0.10958178930651138,0.13912890142831952,0.43675787299948376,0.2302175053939005,0.15729483282674772,0.19984802431610943,0.6428571428571429
Zip,11762,New York,NA,2484,2479,2458,7421,2,3,121,126,921491,1337304,118878819,121137614,940202,8.051529790660225e-4,0.0012101653892698668,0.04922701383238405,0.01697884382158739,0.015873015873015872,0.023809523809523808,0.9603174603174603
Zip,11768,New York,NA,2191,2259,3034,7484,61,54,78,193,50253416,58391066,101766174,210410656,1110381,0.02784116841624829,0.02390438247011952,0.025708635464733027,0.025788348476750402,0.3160621761658031,0.27979274611398963,0.40414507772020725
Zip,11769,New York,NA,50,835,1873,2758,16,139,1014,1169,4662097,52776745,535468175,592907017,436294,0.32,0.1664670658682635,0.5413774693005873,0.42385786802030456,0.013686911890504704,0.11890504704875962,0.8674080410607357
Zip,11770,New York,NA,27,16,1034,1077,17,1,771,789,10236669,1298659,654321267,665856595,746989,0.6296296296296297,0.0625,0.7456479690522244,0.7325905292479109,0.021546261089987327,0.0012674271229404308,0.9771863117870723
Zip,11772,New York,NA,4048,3974,3910,11932,164,394,617,1175,44554597,122376297,359959105,526889999,323841,0.040513833992094864,0.09914443885254152,0.1578005115089514,0.09847468990948709,0.13957446808510637,0.3353191489361702,0.5251063829787234
Zip,11782,New York,NA,230,1434,3549,5213,3,8,599,610,944763,3088301,409721815,413754879,590197,0.013043478260869565,0.005578800557880056,0.16877993801070723,0.1170151544216382,0.004918032786885246,0.013114754098360656,0.9819672131147541
Zip,11783,New York,NA,2283,2289,2298,6870,458,437,690,1585,177756220,207547675,428587649,813891544,488501,0.20061322820849758,0.1909130624726955,0.3002610966057441,0.23071324599708878,0.2889589905362776,0.2757097791798107,0.4353312302839117
Zip,11793,New York,NA,3405,3449,3463,10317,208,294,335,837,84356553,141272565,223744218,449373336,491830,0.061086637298091044,0.08524209915917658,0.09673693329483107,0.08112823495202094,0.24850657108721624,0.35125448028673834,0.4002389486260454
Zip,11795,New York,NA,72,3554,4499,8125,2,34,1394,1430,507530,20167047,1122310053,1142984630,675436.5,0.027777777777777776,0.009566685424873381,0.3098466325850189,0.176,0.0013986013986013986,0.023776223776223775,0.9748251748251748
Zip,11901,New York,NA,3233,3007,2846,9086,71,130,248,449,22291796,47300598,196214913,265807307,458232,0.02196102690999072,0.04323245759893582,0.08713984539704848,0.04941668500990535,0.15812917594654788,0.289532293986637,0.5523385300668151
Zip,11930,New York,NA,328,369,441,1138,45,24,35,104,72925604,62047417,142590928,277563949,2348173,0.13719512195121952,0.06504065040650407,0.07936507936507936,0.0913884007029877,0.4326923076923077,0.23076923076923078,0.33653846153846156
Zip,11934,New York,NA,879,920,991,2790,88,90,160,338,28426964,32414585,118692532,179534081,372344,0.10011376564277588,0.09782608695652174,0.16145307769929365,0.12114695340501792,0.2603550295857988,0.26627218934911245,0.47337278106508873
Zip,11935,New York,NA,692,693,671,2056,51,53,87,191,27904741,38751107,150113764,216769612,793648,0.07369942196531792,0.07647907647907648,0.12965722801788376,0.0928988326848249,0.2670157068062827,0.2774869109947644,0.45549738219895286
Zip,11937,New York,NA,4305,4295,4201,12801,58,112,146,316,59809719,165033263,448406789,673249771,1645912,0.013472706155632985,0.02607683352735739,0.03475363008807427,0.024685571439731272,0.18354430379746836,0.35443037974683544,0.4620253164556962
Zip,11940,New York,NA,614,602,539,1755,13,18,84,115,4574162,7065477,71326685,82966324,590592,0.021172638436482084,0.029900332225913623,0.15584415584415584,0.06552706552706553,0.11304347826086956,0.1565217391304348,0.7304347826086957
Zip,11942,New York,NA,962,923,902,2787,75,69,234,378,34626748,46458129,376203519,457288396,929451.5,0.07796257796257797,0.07475622968580715,0.25942350332594233,0.1356297093649085,0.1984126984126984,0.18253968253968253,0.6190476190476191
Zip,11944,New York,NA,662,663,643,1968,41,77,129,247,19075768,41664594,175963193,236703555,627157,0.061933534743202415,0.11613876319758673,0.2006220839813375,0.12550813008130082,0.1659919028340081,0.3117408906882591,0.5222672064777328
Zip,11946,New York,NA,2280,2275,2257,6812,38,55,324,417,15987783,29055505,405529623,450572911,928382,0.016666666666666666,0.024175824175824177,0.1435533894550288,0.06121550205519671,0.09112709832134293,0.13189448441247004,0.7769784172661871
Zip,11952,New York,NA,789,816,791,2396,52,76,60,188,23662874,43290858,65219567,132173299,562491.5,0.06590621039290241,0.09313725490196079,0.07585335018963338,0.07846410684474124,0.2765957446808511,0.40425531914893614,0.3191489361702128
Zip,11954,New York,NA,1253,1259,1204,3716,141,34,73,248,95735498,34363616,146037145,276136259,824674,0.11252992817238627,0.027005559968228753,0.0606312292358804,0.06673842841765339,0.5685483870967742,0.13709677419354838,0.29435483870967744
Zip,11959,New York,NA,163,226,211,600,2,33,84,119,2745119,65234226,351608214,419587559,3082149,0.012269938650306749,0.14601769911504425,0.3981042654028436,0.19833333333333333,0.01680672268907563,0.2773109243697479,0.7058823529411765
Zip,11963,New York,NA,1743,1651,1801,5195,96,127,201,424,90563311,195257125,619884834,905705270,1655267,0.055077452667814115,0.07692307692307693,0.1116046640755136,0.08161693936477382,0.22641509433962265,0.29952830188679247,0.4740566037735849
Zip,11964,New York,NA,563,563,722,1848,6,16,88,110,5232423,18970441,253005497,277208361,2382217.5,0.010657193605683837,0.028419182948490232,0.12188365650969529,0.05952380952380952,0.05454545454545454,0.14545454545454545,0.8
Zip,11967,New York,NA,2584,2597,2587,7768,271,109,233,613,52732285,27858839,238629514,319220638,230949,0.10487616099071208,0.041971505583365425,0.09006571318129107,0.078913491246138,0.44208809135399674,0.17781402936378465,0.3800978792822186
Zip,11968,New York,NA,2929,2751,2751,8431,122,273,162,557,97999320,396778344,1047478972,1542256636,1432964,0.041652441106179584,0.09923664122137404,0.05888767720828789,0.06606570988020401,0.21903052064631956,0.49012567324955114,0.29084380610412924
Zip,11971,New York,NA,1221,1198,1097,3516,109,149,159,417,53741397,90317642,207248523,351307562,631153,0.08927108927108927,0.12437395659432388,0.14494074749316319,0.11860068259385666,0.26139088729016785,0.35731414868105515,0.381294964028777
Zip,11977,New York,NA,485,501,496,1482,16,24,120,160,10397754,19797247,277525659,307720660,1493758,0.032989690721649485,0.04790419161676647,0.24193548387096775,0.10796221322537113,0.1,0.15,0.75
Zip,11978,New York,NA,1e3,1036,1458,3494,140,378,575,1093,94043133,562757936,2000167158,2656968227,2010655,0.14,0.36486486486486486,0.3943758573388203,0.31282198053806526,0.1280878316559927,0.3458371454711802,0.526075022872827
Zip,19021,Pennsylvania,NA,1083,1081,1049,3213,60,39,54,153,8225645,7208185,12526026,27959856,178349,0.055401662049861494,0.036077705827937095,0.05147759771210677,0.047619047619047616,0.39215686274509803,0.2549019607843137,0.35294117647058826
Zip,19029,Pennsylvania,NA,547,536,538,1621,75,101,131,307,8015840,13266411,22381036,43663287,137604,0.13711151736745886,0.1884328358208955,0.24349442379182157,0.189389265885256,0.24429967426710097,0.3289902280130293,0.42671009771986973
Zip,19106,Pennsylvania,NA,2,34,5616,5652,0,0,258,258,0,0,101301697,101301697,307507,0,0,0.045940170940170943,0.045647558386411886,0,0,1
Zip,19123,Pennsylvania,NA,1,166,4093,4260,0,0,454,454,0,0,215629145,215629145,413598.5,0,0,0.11092108477889079,0.10657276995305165,0,0,1
Zip,19137,Pennsylvania,NA,553,2552,213,3318,2,95,10,107,190358,13849631,2112125,16152114,142910,0.003616636528028933,0.037225705329153605,0.046948356807511735,0.03224834237492465,0.018691588785046728,0.8878504672897196,0.09345794392523364
Zip,19147,Pennsylvania,NA,4,151,13308,13463,0,0,328,328,0,0,173081641,173081641,402302,0,0,0.0246468289750526,0.024363069152492017,0,0,1
Zip,19153,Pennsylvania,NA,826,2475,255,3556,104,483,152,739,8943148,73473978,32004884,114422010,158384,0.12590799031476999,0.19515151515151516,0.596078431372549,0.2078177727784027,0.14073071718538566,0.6535859269282814,0.20568335588633288
Zip,19706,Delaware,NA,241,246,247,734,115,61,84,260,15171423,10631578,24412490,50215491,168364.5,0.47717842323651455,0.24796747967479674,0.340080971659919,0.3542234332425068,0.4423076923076923,0.23461538461538461,0.3230769230769231
Zip,19709,Delaware,NA,2071,2417,7736,12224,3,50,54,107,364871,9776323,23955841,34097035,260406,0.0014485755673587638,0.02068680182043856,0.006980351602895553,0.0087532722513089,0.028037383177570093,0.4672897196261682,0.5046728971962616
Zip,19720,Delaware,NA,6158,6047,5924,18129,70,148,130,348,8879781,27195790,38404437,74480008,190417,0.01136732705423839,0.024474946254340997,0.021944632005401754,0.019195763693529704,0.20114942528735633,0.42528735632183906,0.3735632183908046
Zip,19801,Delaware,NA,2345,1235,634,4214,236,29,39,304,20306799,3865578,11506114,35678491,87417.5,0.10063965884861407,0.02348178137651822,0.061514195583596214,0.07214048410061699,0.7763157894736842,0.09539473684210527,0.12828947368421054
Zip,19802,Delaware,NA,3204,3922,1283,8409,97,15,1,113,8838992,1978130,316046,11133168,93942,0.030274656679151062,0.0038245792962774095,7.79423226812159e-4,0.013437983113330955,0.8584070796460177,0.13274336283185842,0.008849557522123894
Zip,19901,Delaware,NA,4714,5510,3231,13455,317,127,104,548,34812773,20903161,37021256,92737190,127589,0.06724649978786593,0.023049001814882033,0.03218817703497369,0.04072835377183203,0.5784671532846716,0.23175182481751824,0.1897810218978102
Zip,19930,Delaware,NA,1746,1732,1888,5366,420,302,204,926,143401228,139787130,144004924,427193282,416076,0.24054982817869416,0.17436489607390301,0.10805084745762712,0.17256802087215803,0.4535637149028078,0.326133909287257,0.2203023758099352
Zip,19939,Delaware,NA,1171,1206,1170,3547,20,104,182,306,3585498,28148413,78140308,109874219,307633,0.017079419299743808,0.08623548922056384,0.15555555555555556,0.08627008739780095,0.06535947712418301,0.33986928104575165,0.5947712418300654
Zip,19944,Delaware,NA,216,284,357,857,62,88,105,255,25835424,48217236,89108305,163160965,562669,0.28703703703703703,0.30985915492957744,0.29411764705882354,0.2975495915985998,0.24313725490196078,0.34509803921568627,0.4117647058823529
Zip,19945,Delaware,NA,1097,1086,1025,3208,19,68,168,255,3318815,15165239,56072752,74556806,266707,0.01731996353691887,0.06261510128913444,0.16390243902439025,0.07948877805486285,0.07450980392156863,0.26666666666666666,0.6588235294117647
Zip,19946,Delaware,NA,2228,1252,693,4173,205,174,119,498,21849151,25896886,26487868,74233905,128596,0.09201077199281867,0.1389776357827476,0.1717171717171717,0.11933860531991373,0.41164658634538154,0.3493975903614458,0.2389558232931727
Zip,19958,Delaware,NA,4360,4500,4501,13361,130,140,373,643,16733031,42565993,219109510,278408534,397738,0.02981651376146789,0.03111111111111111,0.08287047322817152,0.04812514033380735,0.20217729393468117,0.2177293934681182,0.5800933125972006
Zip,19963,Delaware,NA,2990,2800,2812,8602,159,121,154,434,20013078,22910910,64820722,107744710,185916,0.053177257525083614,0.04321428571428571,0.05476529160739687,0.050453382934201346,0.3663594470046083,0.27880184331797236,0.3548387096774194
Zip,19966,Delaware,NA,4069,4061,4051,12181,1144,159,203,1506,93086830,26823766,72413850,192324446,86867.5,0.28115015974440893,0.03915291800049249,0.05011108368304122,0.12363516952631147,0.7596281540504648,0.10557768924302789,0.1347941567065073
Zip,19968,Delaware,NA,1844,1891,2011,5746,44,53,71,168,8041029,13153338,33248606,54442973,263088,0.02386117136659436,0.028027498677948175,0.035305818000994534,0.02923773059519666,0.2619047619047619,0.31547619047619047,0.4226190476190476
Zip,19970,Delaware,NA,2082,1969,2168,6219,298,238,309,845,64480129,69084685,138412928,271977742,293666,0.1431316042267051,0.12087353986795328,0.14252767527675278,0.1358739347161923,0.3526627218934911,0.2816568047337278,0.3656804733727811
Zip,19971,Delaware,NA,2452,2481,2440,7373,55,21,33,109,14103525,8359280,25047881,47510686,358782,0.022430668841761828,0.008464328899637243,0.013524590163934426,0.014783670147836702,0.5045871559633027,0.1926605504587156,0.30275229357798167
Zip,19973,Delaware,NA,2869,2900,2857,8626,20,38,56,114,2344842,6159243,16090599,24594684,180237.5,0.006971070059254096,0.01310344827586207,0.01960098004900245,0.013215859030837005,0.17543859649122806,0.3333333333333333,0.49122807017543857
Zip,19975,Delaware,NA,1582,1622,1516,4720,509,486,775,1770,90569827,137912913,347985815,576468555,304033.5,0.3217446270543616,0.2996300863131936,0.5112137203166227,0.375,0.28757062146892653,0.2745762711864407,0.4378531073446328
Zip,19977,Delaware,NA,4462,3896,3906,12264,131,41,25,197,13691915,7783508,9301733,30777156,113967,0.02935903182429404,0.010523613963039014,0.006400409626216078,0.01606327462491846,0.6649746192893401,0.20812182741116753,0.12690355329949238
Zip,20629,Maryland,NA,224,274,270,768,5,60,72,137,1139747,17335008,26656764,45131519,328337,0.022321428571428572,0.21897810218978103,0.26666666666666666,0.17838541666666666,0.0364963503649635,0.43795620437956206,0.5255474452554745
Zip,20650,Maryland,NA,1714,1807,1731,5252,85,119,53,257,20392313,37680193,27870745,85943251,300391,0.049591598599766626,0.06585500830105147,0.030618139803581745,0.04893373952779893,0.33073929961089493,0.46303501945525294,0.20622568093385213
Zip,20657,Maryland,NA,3442,3442,3438,10322,121,52,146,319,20017675,11655875,60412069,92085619,232357,0.03515398024404416,0.015107495642068565,0.04246655031995346,0.03090486339856617,0.3793103448275862,0.16300940438871472,0.45768025078369906
Zip,20659,Maryland,NA,2854,3003,2925,8782,132,62,94,288,28473033,15803147,38140317,82416497,244891.5,0.046250875963559916,0.020646020646020648,0.032136752136752135,0.032794352083807786,0.4583333333333333,0.2152777777777778,0.3263888888888889
Zip,20664,Maryland,NA,536,546,532,1614,45,60,62,167,9245061,15667104,28226288,53138453,271237,0.08395522388059702,0.10989010989010989,0.11654135338345864,0.10346964064436183,0.2694610778443114,0.3592814371257485,0.3712574850299401
Zip,20674,Maryland,NA,184,204,180,568,119,170,165,454,24393409,53523264,86483705,164400378,333653,0.6467391304347826,0.8333333333333334,0.9166666666666666,0.7992957746478874,0.2621145374449339,0.3744493392070485,0.3634361233480176
Zip,20680,Maryland,NA,162,164,173,499,19,27,64,110,4279853,8539616,31683639,44503108,374511,0.11728395061728394,0.16463414634146342,0.3699421965317919,0.22044088176352705,0.17272727272727273,0.24545454545454545,0.5818181818181818
Zip,20685,Maryland,NA,941,1116,937,2994,33,178,42,253,6726703,43065769,22061139,71853611,235655,0.03506907545164718,0.15949820788530467,0.044823906083244394,0.08450233800935204,0.13043478260869565,0.7035573122529645,0.16600790513833993
Zip,20687,Maryland,NA,83,88,86,257,55,61,73,189,10106289,16663508,32179736,58949533,282747,0.6626506024096386,0.6931818181818182,0.8488372093023255,0.7354085603112841,0.291005291005291,0.32275132275132273,0.3862433862433862
Zip,20688,Maryland,NA,307,254,270,831,46,29,31,106,10406036,7924938,17708124,36039098,259276,0.1498371335504886,0.1141732283464567,0.11481481481481481,0.12755716004813478,0.4339622641509434,0.27358490566037735,0.29245283018867924
Zip,20690,Maryland,NA,151,145,154,450,84,76,91,251,18934125,23933288,52334254,95201667,327069,0.5562913907284768,0.5241379310344828,0.5909090909090909,0.5577777777777778,0.3346613545816733,0.30278884462151395,0.36254980079681276
Zip,20714,Maryland,NA,786,742,625,2153,58,89,163,310,12482175,24843605,77063553,114389333,316874.5,0.0737913486005089,0.11994609164420485,0.2608,0.14398513701811425,0.1870967741935484,0.2870967741935484,0.5258064516129032
Zip,20732,Maryland,NA,1528,1555,1499,4582,93,88,123,304,21265989,27258794,63964727,112489510,314437,0.06086387434554974,0.05659163987138264,0.08205470313542361,0.0663465735486687,0.3059210526315789,0.2894736842105263,0.40460526315789475
Zip,20733,Maryland,NA,468,455,467,1390,104,100,197,401,27570416,33226582,115493005,176290003,351303,0.2222222222222222,0.21978021978021978,0.42184154175588867,0.2884892086330935,0.2593516209476309,0.24937655860349128,0.4912718204488778
Zip,20751,Maryland,NA,379,391,397,1167,116,97,152,365,32265654,35098818,96989121,164353593,376460,0.30606860158311344,0.24808184143222506,0.38287153652392947,0.31276778063410454,0.3178082191780822,0.26575342465753427,0.41643835616438357
Zip,20764,Maryland,NA,787,762,761,2310,402,386,393,1181,94051036,118802674,235208618,448062328,304791,0.5108005082592122,0.5065616797900262,0.5164257555847569,0.5112554112554113,0.34038950042337,0.3268416596104996,0.3327688399661304
Zip,21037,Maryland,NA,3037,3001,3050,9088,200,285,258,743,57890860,109574377,192631985,360097222,389269,0.0658544616397761,0.09496834388537154,0.08459016393442623,0.08175616197183098,0.2691790040376851,0.3835800807537012,0.3472409152086137
Zip,21078,Maryland,NA,2643,2690,2700,8033,18,91,67,176,3244212,20268125,29147301,52659638,227995.5,0.00681044267877412,0.03382899628252788,0.024814814814814814,0.021909622805925556,0.10227272727272728,0.5170454545454546,0.3806818181818182
Zip,21122,Maryland,NA,8031,7972,7876,23879,46,113,358,517,11324419,36361667,212835994,260522080,442307,0.005727804756568298,0.014174611138986453,0.045454545454545456,0.021650822898781355,0.08897485493230174,0.218568665377176,0.6924564796905223
Zip,21146,Maryland,NA,3287,3430,3440,10157,2,21,97,120,804187,10349765,108564623,119718575,895172.5,6.08457560085184e-4,0.006122448979591836,0.02819767441860465,0.011814512159102097,0.016666666666666666,0.175,0.8083333333333333
Zip,21219,Maryland,NA,1083,1091,1498,3672,80,169,528,777,15514751,41874500,215655867,273045118,314968,0.07386888273314866,0.15490375802016498,0.35246995994659547,0.21160130718954248,0.10296010296010295,0.2175032175032175,0.6795366795366795
Zip,21220,Maryland,NA,4156,3966,3960,12082,48,187,1108,1343,7426460,39793484,490754708,537974652,365999,0.011549566891241578,0.04715078164397378,0.2797979797979798,0.11115709319649064,0.035740878629932984,0.13924050632911392,0.8250186150409531
Zip,21221,Maryland,NA,4292,4240,4428,12960,42,123,238,403,6091003,23469333,90835887,120396223,255551,0.0097856477166822,0.02900943396226415,0.05374887082204156,0.031095679012345678,0.10421836228287841,0.3052109181141439,0.5905707196029777
Zip,21222,Maryland,NA,5335,7161,6483,18979,154,122,739,1015,13537158,17838845,172686959,204062962,182416,0.0288659793814433,0.01703672671414607,0.11399043652629955,0.05348016228463038,0.15172413793103448,0.12019704433497537,0.7280788177339902
Zip,21231,Maryland,NA,10,537,5026,5573,0,10,803,813,0,1555784,277657200,279212984,267271,0,0.0186219739292365,0.15976920015917231,0.1458819307374843,0,0.012300123001230012,0.9876998769987699
Zip,21403,Maryland,NA,4189,3658,4175,12022,72,200,381,653,21243729,83205794,419305980,523755503,582123,0.017187873000716163,0.05467468562055768,0.09125748502994012,0.054317085343536846,0.11026033690658499,0.30627871362940273,0.5834609494640123
Zip,21601,Maryland,NA,3058,3072,3033,9163,6,9,183,198,1305991,2674720,256538050,260518761,991121,0.001962066710268149,0.0029296875,0.06033630069238378,0.021608643457382955,0.030303030303030304,0.045454545454545456,0.9242424242424242
Zip,21612,Maryland,NA,109,117,156,382,15,39,51,105,3917341,19244669,59142481,82304491,711443,0.13761467889908258,0.3333333333333333,0.3269230769230769,0.27486910994764396,0.14285714285714285,0.37142857142857144,0.4857142857142857
Zip,21613,Maryland,NA,3387,3338,3262,9987,61,365,1280,1706,5318020,50011097,443811470,499140587,246158,0.01801003838204901,0.10934691431995207,0.3923973022685469,0.17082206868929609,0.03575615474794842,0.21395076201641267,0.7502930832356389
Zip,21619,Maryland,NA,979,983,988,2950,86,131,195,412,20712274,43471676,133314563,197498513,379953.5,0.08784473953013279,0.13326551373346898,0.19736842105263158,0.13966101694915253,0.2087378640776699,0.3179611650485437,0.4733009708737864
Zip,21620,Maryland,NA,1998,2149,2201,6348,13,46,153,212,1972099,9624525,86346902,97943526,384496,0.0065065065065065065,0.021405304792926943,0.06951385733757383,0.03339634530560807,0.06132075471698113,0.2169811320754717,0.7216981132075472
Zip,21622,Maryland,NA,129,134,188,451,121,118,173,412,12665195,21261499,62363825,96290519,198388.5,0.937984496124031,0.8805970149253731,0.9202127659574468,0.9135254988913526,0.2936893203883495,0.28640776699029125,0.4199029126213592
Zip,21626,Maryland,NA,69,41,35,145,68,40,34,142,6243449,5088796,8646040,19978285,109437.5,0.9855072463768116,0.975609756097561,0.9714285714285714,0.9793103448275862,0.4788732394366197,0.28169014084507044,0.23943661971830985
Zip,21638,Maryland,NA,758,757,755,2270,222,301,322,845,50786409,113831406,204758466,369376281,417322,0.2928759894459103,0.39762219286657857,0.42649006622516555,0.3722466960352423,0.26272189349112424,0.3562130177514793,0.3810650887573965
Zip,21648,Maryland,NA,66,59,61,186,64,59,61,184,9022962,12038199,23823121,44884282,199268,0.9696969696969697,1,1,0.989247311827957,0.34782608695652173,0.32065217391304346,0.33152173913043476
Zip,21654,Maryland,NA,298,296,307,901,178,135,104,417,53705752,82131191,160275402,296112345,485948,0.5973154362416108,0.4560810810810811,0.33876221498371334,0.462819089900111,0.42685851318944845,0.3237410071942446,0.24940047961630696
Zip,21661,Maryland,NA,639,651,663,1953,154,279,325,758,23065758,56154780,162121035,241341573,222242,0.24100156494522693,0.42857142857142855,0.49019607843137253,0.38812083973374295,0.20316622691292877,0.36807387862796836,0.4287598944591029
Zip,21662,Maryland,NA,154,169,226,549,23,77,119,219,6263204,47546789,176529169,230339162,946200,0.14935064935064934,0.4556213017751479,0.5265486725663717,0.3989071038251366,0.1050228310502283,0.3515981735159817,0.54337899543379
Zip,21663,Maryland,NA,649,661,654,1964,32,83,186,301,7351397,36460374,203913376,247725147,715627,0.04930662557781202,0.12556732223903178,0.28440366972477066,0.15325865580448064,0.10631229235880399,0.2757475083056478,0.6179401993355482
Zip,21666,Maryland,NA,2067,2078,2120,6265,511,278,294,1083,128607712,93953146,191772469,414333327,295891,0.24721819061441702,0.13378248315688163,0.13867924528301886,0.17286512370311252,0.47183748845798706,0.2566943674976916,0.27146814404432135
Zip,21669,Maryland,NA,90,89,102,281,88,89,101,278,11779064,19837972,44007492,75624528,231736.5,0.9777777777777777,1,0.9901960784313726,0.9893238434163701,0.31654676258992803,0.32014388489208634,0.36330935251798563
Zip,21671,Maryland,NA,270,269,272,811,77,102,118,297,14581385,32239357,72054078,118874820,351519,0.2851851851851852,0.379182156133829,0.4338235294117647,0.36621454993834773,0.25925925925925924,0.3434343434343434,0.39730639730639733
Zip,21672,Maryland,NA,83,93,85,261,83,92,85,260,5759071,7667033,12947776,26373880,83453.5,1,0.989247311827957,1,0.9961685823754789,0.3192307692307692,0.35384615384615387,0.3269230769230769
Zip,21675,Maryland,NA,42,30,42,114,42,30,41,113,2991505,2558744,7258307,12808556,83478,1,1,0.9761904761904762,0.9912280701754386,0.37168141592920356,0.26548672566371684,0.36283185840707965
Zip,21677,Maryland,NA,82,108,98,288,82,107,98,287,15294228,30212959,54174946,99682133,296086,1,0.9907407407407407,1,0.9965277777777778,0.2857142857142857,0.37282229965156793,0.34146341463414637
Zip,21801,Maryland,NA,3183,2761,4218,10162,30,32,167,229,2750659,4311756,58250828,65313243,218055,0.00942507068803016,0.011590003621876132,0.03959222380275012,0.02253493406809683,0.13100436681222707,0.13973799126637554,0.7292576419213974
Zip,21811,Maryland,NA,4847,5348,5500,15695,923,1340,2808,5071,141506326,302630492,1248463758,1692600576,280668,0.19042706828966371,0.2505609573672401,0.5105454545454545,0.32309652755654666,0.1820153815815421,0.2642476829027805,0.5537369355156774
Zip,21813,Maryland,NA,611,609,625,1845,32,174,251,457,5604092,44302019,138834452,188740563,359667,0.05237315875613748,0.2857142857142857,0.4016,0.24769647696476965,0.0700218818380744,0.38074398249452956,0.5492341356673961
Zip,21817,Maryland,NA,1082,1180,1078,3340,1070,1171,1068,3309,67335354,97430089,192329053,357094496,77546,0.988909426987061,0.9923728813559322,0.9907235621521335,0.9907185628742515,0.32336053188274405,0.35388334844363856,0.3227561196736174
Zip,21821,Maryland,NA,424,399,412,1235,367,337,299,1003,30998472,40783183,70427405,142209060,114885,0.8655660377358491,0.8446115288220551,0.7257281553398058,0.8121457489878543,0.3659022931206381,0.33599202392821537,0.29810568295114653
Zip,21824,Maryland,NA,90,82,90,262,90,82,90,262,7455876,7435019,12968609,27859504,90156,1,1,1,1,0.3435114503816794,0.31297709923664124,0.3435114503816794
Zip,21838,Maryland,NA,425,440,483,1348,328,321,409,1058,21284269,27546022,90032096,138862387,85966,0.7717647058823529,0.7295454545454545,0.8467908902691511,0.7848664688427299,0.31001890359168244,0.30340264650283555,0.38657844990548207
Zip,21840,Maryland,NA,167,172,170,509,35,42,74,151,3374859,4910599,18932949,27218407,125625,0.20958083832335328,0.2441860465116279,0.43529411764705883,0.2966601178781925,0.23178807947019867,0.2781456953642384,0.4900662251655629
Zip,21842,Maryland,NA,11730,11783,11348,34861,8476,7103,6805,22384,1256591744,1712489478,3256668455,6225749677,228589.5,0.7225916453537937,0.6028176186030723,0.5996651392315827,0.6420928831645678,0.37866333095067906,0.3173248749106505,0.30401179413867047
Zip,21851,Maryland,NA,1398,1345,1301,4044,155,147,116,418,13831086,18317719,29511882,61660687,120311.5,0.11087267525035766,0.10929368029739776,0.08916218293620293,0.10336300692383778,0.3708133971291866,0.35167464114832536,0.27751196172248804
Zip,21853,Maryland,NA,1331,1429,1434,4194,278,209,233,720,21008427,24124088,58878530,104011045,111144,0.20886551465063863,0.1462561231630511,0.16248256624825663,0.17167381974248927,0.3861111111111111,0.2902777777777778,0.3236111111111111
Zip,21856,Maryland,NA,204,202,196,602,44,38,48,130,3997268,5001627,13952404,22951299,131486.5,0.21568627450980393,0.18811881188118812,0.24489795918367346,0.2159468438538206,0.3384615384615385,0.2923076923076923,0.36923076923076925
Zip,21863,Maryland,NA,938,968,942,2848,75,56,117,248,7704889,8252643,37751590,53709122,164234,0.07995735607675906,0.05785123966942149,0.12420382165605096,0.08707865168539326,0.3024193548387097,0.22580645161290322,0.4717741935483871
Zip,21865,Maryland,NA,172,184,164,520,98,129,94,321,8836985,14377172,18370959,41585116,108806,0.5697674418604651,0.7010869565217391,0.573170731707317,0.6173076923076923,0.3052959501557632,0.40186915887850466,0.29283489096573206
Zip,21869,Maryland,NA,254,248,228,730,30,65,70,165,2474649,8056982,22974746,33506377,129726,0.11811023622047244,0.2620967741935484,0.30701754385964913,0.22602739726027396,0.18181818181818182,0.3939393939393939,0.42424242424242425
Zip,21871,Maryland,NA,453,539,588,1580,247,257,275,779,17429400,27314352,66819952,111563704,109253,0.5452538631346578,0.47680890538033394,0.467687074829932,0.4930379746835443,0.3170731707317073,0.3299101412066752,0.35301668806161746
Zip,21901,Maryland,NA,2410,2415,2344,7169,89,66,105,260,14470406,14354762,64154928,92980096,224144.5,0.036929460580912864,0.02732919254658385,0.04479522184300341,0.03626726182173246,0.3423076923076923,0.25384615384615383,0.40384615384615385
Zip,21903,Maryland,NA,784,851,856,2491,10,37,55,102,1559806,7867148,21432532,30859486,260047.5,0.012755102040816327,0.043478260869565216,0.06425233644859812,0.040947410678442396,0.09803921568627451,0.3627450980392157,0.5392156862745098
Zip,21921,Maryland,NA,5270,5284,5403,15957,12,47,95,154,2063858,10010673,41149066,53223597,316059,0.0022770398481973433,0.008894776684330053,0.017582824356838795,0.009650936892899668,0.07792207792207792,0.3051948051948052,0.6168831168831169
Zip,22307,Virginia,NA,1483,1097,1970,4550,181,215,62,458,38116031,69980232,45692041,153788304,248578,0.12204989885367498,0.1959890610756609,0.03147208121827411,0.10065934065934067,0.3951965065502183,0.46943231441048033,0.13537117903930132
Zip,22454,Virginia,NA,368,368,385,1121,2,31,100,133,261398,5260798,37242989,42765185,317784,0.005434782608695652,0.08423913043478261,0.2597402597402597,0.11864406779661017,0.015037593984962405,0.23308270676691728,0.7518796992481203
Zip,22503,Virginia,NA,621,598,618,1837,39,52,68,159,4903287,11394193,31788252,48085732,247628,0.06280193236714976,0.08695652173913043,0.11003236245954692,0.08655416439847577,0.24528301886792453,0.3270440251572327,0.4276729559748428
Zip,22554,Virginia,NA,5166,5534,5740,16440,15,65,44,124,3897418,21450085,23565857,48913360,344004,0.0029036004645760743,0.0117455728225515,0.007665505226480836,0.00754257907542579,0.12096774193548387,0.5241935483870968,0.3548387096774194
Zip,22560,Virginia,NA,839,812,818,2469,0,54,140,194,0,10441401,48609330,59050731,265546,0,0.0665024630541872,0.17114914425427874,0.07857432158768732,0,0.27835051546391754,0.7216494845360825
Zip,22578,Virginia,NA,458,448,462,1368,73,159,171,403,12149734,54692589,118131703,184974026,452094,0.15938864628820962,0.3549107142857143,0.37012987012987014,0.2945906432748538,0.18114143920595532,0.3945409429280397,0.42431761786600497
Zip,23043,Virginia,NA,515,538,594,1647,53,156,102,311,9537579,42787589,52709233,105034401,290326,0.1029126213592233,0.2899628252788104,0.1717171717171717,0.18882817243472982,0.17041800643086816,0.5016077170418006,0.3279742765273312
Zip,23061,Virginia,NA,2853,2857,2735,8445,97,76,337,510,15373671,16228477,149562198,181164346,338638.5,0.03399929898352611,0.026601330066503327,0.12321755027422303,0.06039076376554174,0.19019607843137254,0.14901960784313725,0.6607843137254902
Zip,23072,Virginia,NA,1503,1513,1482,4498,440,369,511,1320,67358181,80329206,203970850,351658237,216472.5,0.2927478376580173,0.24388631857237278,0.344804318488529,0.2934637616718542,0.3333333333333333,0.27954545454545454,0.38712121212121214
Zip,23089,Virginia,NA,615,587,594,1796,68,93,86,247,11996657,23656131,35521127,71173915,259739,0.11056910569105691,0.15843270868824533,0.1447811447811448,0.13752783964365256,0.27530364372469635,0.3765182186234818,0.3481781376518219
Zip,23138,Virginia,NA,114,125,97,336,44,54,60,158,6635474,10922044,21785091,39342609,209108.5,0.38596491228070173,0.432,0.6185567010309279,0.47023809523809523,0.27848101265822783,0.34177215189873417,0.379746835443038
Zip,23181,Virginia,NA,465,460,444,1369,27,32,49,108,4137058,6321146,16378577,26836781,210897.5,0.05806451612903226,0.06956521739130435,0.11036036036036036,0.07888970051132213,0.25,0.2962962962962963,0.4537037037037037
Zip,23185,Virginia,NA,5442,4678,5279,15399,8,30,89,127,1270351,9060133,50968902,61299386,413768,0.001470047776552738,0.006412997007268063,0.016859253646523964,0.008247288784986038,0.06299212598425197,0.23622047244094488,0.7007874015748031
Zip,23310,Virginia,NA,285,329,311,925,58,53,51,162,10199675,14349755,24113496,48662926,263865,0.20350877192982456,0.16109422492401215,0.1639871382636656,0.17513513513513512,0.35802469135802467,0.3271604938271605,0.3148148148148148
Zip,23314,Virginia,NA,966,1019,1032,3017,9,30,78,117,1668856,7636229,34711378,44016463,353540,0.009316770186335404,0.029440628066732092,0.0755813953488372,0.038780245276765,0.07692307692307693,0.2564102564102564,0.6666666666666666
Zip,23320,Virginia,NA,6713,6833,4499,18045,761,817,319,1897,127375218,214425737,157725682,499526637,243244,0.11336213317443766,0.1195668081369823,0.07090464547677261,0.10512607370462732,0.4011597258829731,0.4306800210859251,0.16816025303110174
Zip,23321,Virginia,NA,3992,4257,3745,11994,19,100,179,298,3404432,27247021,85381264,116032717,348494.5,0.004759519038076153,0.02349072116513977,0.047797062750333776,0.024845756211439054,0.06375838926174497,0.33557046979865773,0.6006711409395973
Zip,23322,Virginia,NA,1631,5729,12785,20145,57,450,468,975,10945348,121321523,212819078,345085949,314171,0.03494788473329246,0.07854773957060569,0.036605396949550256,0.04839910647803425,0.05846153846153846,0.46153846153846156,0.48
Zip,23323,Virginia,NA,3645,4789,3265,11699,346,349,452,1147,60795597,88215775,187020550,336031922,261293,0.09492455418381344,0.07287533931927334,0.13843797856049003,0.09804256774083255,0.3016564952048823,0.3042720139494333,0.3940714908456844
Zip,23324,Virginia,NA,5062,987,57,6106,189,31,4,224,28596815,7306724,2414470,38318009,159942.5,0.037337020940339784,0.031408308004052685,0.07017543859649122,0.0366852276449394,0.84375,0.13839285714285715,0.017857142857142856
Zip,23325,Virginia,NA,3351,1991,281,5623,22,64,41,127,4306233,16652455,84905098,105863786,271168,0.006565204416592062,0.03214465092918132,0.14590747330960854,0.02258580828739107,0.1732283464566929,0.5039370078740157,0.3228346456692913
Zip,23336,Virginia,NA,301,302,303,906,301,302,303,906,56011709,72380680,106426540,234818929,239950.5,1,1,1,1,0.3322295805739514,0.3333333333333333,0.3344370860927152
Zip,23417,Virginia,NA,320,330,328,978,108,61,171,340,12989086,11094327,52287879,76371292,217678.5,0.3375,0.18484848484848485,0.5213414634146342,0.3476482617586912,0.3176470588235294,0.17941176470588235,0.5029411764705882
Zip,23430,Virginia,NA,2176,2228,2245,6649,15,18,146,179,2197497,4226132,67858359,74281988,391737,0.006893382352941176,0.00807899461400359,0.06503340757238307,0.026921341555121072,0.08379888268156424,0.1005586592178771,0.8156424581005587
Zip,23434,Virginia,NA,7232,5381,3372,15985,17,48,45,110,2678234,10420801,19561444,32660479,244142,0.0023506637168141595,0.008920275041813789,0.013345195729537367,0.00688145136065061,0.15454545454545454,0.43636363636363634,0.4090909090909091
Zip,23435,Virginia,NA,1369,2927,4603,8899,0,22,255,277,0,5423517,124153116,129576633,347947,0,0.007516228220020499,0.05539865305235716,0.031127092931790088,0,0.07942238267148015,0.9205776173285198
Zip,23451,Virginia,NA,3192,2358,9790,15340,805,535,1975,3315,142652913,146162289,1113111630,1401926832,361742,0.25219298245614036,0.2268871925360475,0.2017364657814096,0.21610169491525424,0.24283559577677225,0.16138763197586728,0.5957767722473605
Zip,23452,Virginia,NA,7258,6637,3982,17877,920,490,328,1738,155827238,120038361,244521419,520387018,219623.5,0.1267566822816203,0.07382853698960373,0.08237066800602712,0.09721989148067349,0.5293440736478712,0.2819332566168009,0.18872266973532797
Zip,23453,Virginia,NA,5279,3530,1916,10725,158,132,93,383,25413032,35636460,33762119,94811611,252490,0.029929910967986362,0.037393767705382434,0.048538622129436326,0.035710955710955714,0.412532637075718,0.34464751958224543,0.24281984334203655
Zip,23454,Virginia,NA,5648,6061,6925,18634,1058,1018,625,2701,183491079,281811694,402814973,868117746,263693,0.18732294617563738,0.1679590826596271,0.09025270758122744,0.14495009123108296,0.3917067752684191,0.37689744539059605,0.23139577934098482
Zip,23455,Virginia,NA,4738,4272,6853,15863,19,128,738,885,3220275,35499596,377544455,416264326,415408,0.004010130856901647,0.0299625468164794,0.10769006274624252,0.05579020361848326,0.021468926553672316,0.14463276836158193,0.8338983050847457
Zip,23456,Virginia,NA,1685,6186,11384,19255,99,134,1350,1583,14320135,36672199,781132075,832124409,508833,0.05875370919881306,0.021661817006142902,0.11858749121574139,0.08221241236042587,0.06253948199620973,0.08464939987365762,0.8528111181301327
Zip,23457,Virginia,NA,68,381,967,1416,34,145,371,550,6909086,38951435,177590053,223450574,391454.5,0.5,0.3805774278215223,0.38366080661840746,0.3884180790960452,0.06181818181818182,0.2636363636363636,0.6745454545454546
Zip,23462,Virginia,NA,12539,5605,1124,19268,50,167,89,306,8007679,45197534,32675386,85880599,282332,0.003987558816492543,0.029794826048171276,0.0791814946619217,0.01588125389246419,0.16339869281045752,0.545751633986928,0.2908496732026144
Zip,23464,Virginia,NA,7009,12255,4394,23658,50,81,226,357,9651832,22240519,93008551,124900902,355058,0.007133685261806249,0.006609547123623011,0.051433773327264454,0.015090032969819934,0.1400560224089636,0.226890756302521,0.6330532212885154
Zip,23502,Virginia,NA,1576,2755,1417,5748,12,148,321,481,1706286,29233731,110897595,141837612,240730,0.007614213197969543,0.05372050816696915,0.22653493295695132,0.0836812804453723,0.02494802494802495,0.3076923076923077,0.6673596673596673
Zip,23503,Virginia,NA,2648,3599,2448,8695,430,395,677,1502,55864435,73747309,247109951,376721695,206864.5,0.1623867069486405,0.10975270908585719,0.27655228758169936,0.17274295572167914,0.2862849533954727,0.262982689747004,0.4507323568575233
Zip,23504,Virginia,NA,2210,1286,934,4430,56,51,60,167,7162112,9318395,19011408,35491915,180087,0.025339366515837104,0.03965785381026438,0.06423982869379015,0.03769751693002257,0.33532934131736525,0.30538922155688625,0.3592814371257485
Zip,23505,Virginia,NA,1778,1387,2595,5760,192,77,418,687,22048048,14702227,219819033,256569308,284322,0.10798650168728909,0.0555155010814708,0.16107899807321774,0.11927083333333334,0.2794759825327511,0.11208151382823872,0.6084425036390102
Zip,23507,Virginia,NA,103,271,1406,1780,22,117,164,303,3136240,20259845,76500160,99896245,239446,0.21359223300970873,0.4317343173431734,0.1166429587482219,0.1702247191011236,0.07260726072607261,0.38613861386138615,0.5412541254125413
Zip,23508,Virginia,NA,941,860,3089,4890,137,49,948,1134,16382595,9040222,417482560,442905377,370145.5,0.14558979808714134,0.056976744186046514,0.30689543541599223,0.23190184049079754,0.12081128747795414,0.043209876543209874,0.8359788359788359
Zip,23509,Virginia,NA,2155,1170,1156,4481,49,70,161,280,6481609,12780230,84754147,104015986,253690,0.022737819025522042,0.05982905982905983,0.13927335640138408,0.0624860522204865,0.175,0.25,0.575
Zip,23510,Virginia,NA,22,347,871,1240,9,144,522,675,1279940,28163884,218284710,247728534,309885,0.4090909090909091,0.414985590778098,0.5993111366245695,0.5443548387096774,0.013333333333333334,0.21333333333333335,0.7733333333333333
Zip,23513,Virginia,NA,4729,2721,1013,8463,76,90,55,221,10306121,16795941,13685413,40787475,179900,0.016071050962148444,0.03307607497243661,0.054294175715695954,0.026113671274961597,0.3438914027149321,0.4072398190045249,0.248868778280543
Zip,23517,Virginia,NA,264,238,613,1115,21,41,73,135,3274443,7464257,29153452,39892152,243466,0.07954545454545454,0.1722689075630252,0.11908646003262642,0.1210762331838565,0.15555555555555556,0.3037037037037037,0.5407407407407407
Zip,23518,Virginia,NA,1604,4066,3389,9059,234,397,739,1370,32883875,76457289,248711066,358052230,228970,0.14588528678304238,0.09763895720609936,0.21805842431395692,0.1512308201788277,0.1708029197080292,0.28978102189781024,0.5394160583941606
Zip,23607,Virginia,NA,5264,584,268,6116,330,14,5,349,34177899,2442981,1353365,37974245,101152,0.06268996960486323,0.023972602739726026,0.018656716417910446,0.05706344015696534,0.9455587392550143,0.04011461318051576,0.014326647564469915
Zip,23608,Virginia,NA,2975,4759,3642,11376,7,13,93,113,860459,2448465,31783676,35092600,291393,0.002352941176470588,0.0027316663164530363,0.025535420098846788,0.009933192686357244,0.061946902654867256,0.11504424778761062,0.8230088495575221
Zip,23661,Virginia,NA,2800,1963,835,5598,52,98,152,302,5705106,16020341,43563799,65289246,192616.5,0.018571428571428572,0.049923586347427405,0.18203592814371258,0.05394783851375491,0.17218543046357615,0.32450331125827814,0.5033112582781457
Zip,23662,Virginia,NA,1399,1410,1410,4219,1119,1010,1003,3132,224504938,312039472,502997017,1039541427,304557,0.7998570407433881,0.7163120567375887,0.7113475177304964,0.7423560085328277,0.35727969348659006,0.322477650063857,0.320242656449553
Zip,23663,Virginia,NA,2796,1550,409,4755,50,83,72,205,5724710,13397102,22992616,42114428,167039,0.0178826895565093,0.053548387096774196,0.17603911980440098,0.04311251314405889,0.24390243902439024,0.40487804878048783,0.35121951219512193
Zip,23664,Virginia,NA,926,1076,2120,4122,297,598,986,1881,35195438,97731368,311411401,444338207,194673,0.3207343412526998,0.5557620817843866,0.4650943396226415,0.45633187772925765,0.15789473684210525,0.31791600212652843,0.5241892610313663
Zip,23666,Virginia,NA,3351,5930,5847,15128,111,426,537,1074,13393396,71986149,130860175,216239720,191140,0.03312444046553268,0.07183811129848229,0.0918419702411493,0.0709941829719725,0.10335195530726257,0.39664804469273746,0.5
Zip,23669,Virginia,NA,4426,3902,5394,13722,545,976,1860,3381,61571444,162038672,544893235,768503351,198341,0.12313601446000903,0.2501281394156843,0.3448275862068966,0.24639265413205072,0.16119491274770778,0.2886719905353446,0.5501330967169477
Zip,23692,Virginia,NA,2166,2428,1463,6057,55,126,126,307,12609365,38879713,59723533,111212611,339823,0.025392428439519853,0.051894563426688634,0.0861244019138756,0.050685157668812944,0.1791530944625407,0.41042345276872966,0.41042345276872966
Zip,23693,Virginia,NA,1844,2053,3309,7206,97,51,89,237,18237192,15939546,47688216,81864954,315940,0.05260303687635575,0.02484169508037019,0.026896343306134784,0.03288925895087427,0.4092827004219409,0.21518987341772153,0.3755274261603376
Zip,23696,Virginia,NA,318,312,314,944,162,115,56,333,35023167,33949856,23435251,92408274,259980,0.5094339622641509,0.3685897435897436,0.17834394904458598,0.3527542372881356,0.4864864864864865,0.34534534534534533,0.16816816816816818
Zip,23701,Virginia,NA,2381,3459,2203,8043,32,78,100,210,3614871,11564180,27623845,42802896,174234,0.013439731205375893,0.022549869904596703,0.04539264639128461,0.02610966057441253,0.1523809523809524,0.37142857142857144,0.47619047619047616
Zip,23702,Virginia,NA,1582,921,198,2701,93,52,9,154,9482676,7903289,1892387,19278352,119167,0.058786346396965866,0.05646036916395222,0.045454545454545456,0.05701592002961866,0.6038961038961039,0.33766233766233766,0.05844155844155844
Zip,23703,Virginia,NA,1704,1574,4789,8067,21,11,142,174,2152409,1745288,45810244,49707941,252992.5,0.01232394366197183,0.00698856416772554,0.02965128419294216,0.021569356638155446,0.1206896551724138,0.06321839080459771,0.8160919540229885
Zip,23704,Virginia,NA,2096,1755,863,4714,209,137,272,618,21172193,20811574,74454044,116437811,163884.5,0.09971374045801527,0.07806267806267807,0.31517960602549244,0.13109885447602884,0.33818770226537215,0.22168284789644013,0.4401294498381877
Zip,23707,Virginia,NA,1543,1544,1179,4266,84,52,131,267,9622876,7918684,37259396,54800956,176184,0.05443940375891121,0.03367875647668394,0.1111111111111111,0.06258790436005626,0.3146067415730337,0.1947565543071161,0.49063670411985016
Zip,27810,North Carolina,NA,84,81,84,249,81,74,72,227,4782326,7801746,16162898,28746970,97602,0.9642857142857143,0.9135802469135802,0.8571428571428571,0.9116465863453815,0.3568281938325991,0.32599118942731276,0.31718061674008813
Zip,27824,North Carolina,NA,64,65,69,198,47,61,59,167,4664359,7374781,11492067,23531207,123686,0.734375,0.9384615384615385,0.855072463768116,0.8434343434343434,0.281437125748503,0.3652694610778443,0.3532934131736527
Zip,27826,North Carolina,NA,40,42,39,121,40,42,39,121,3645841,4983183,9047998,17677022,113994,1,1,1,1,0.3305785123966942,0.34710743801652894,0.32231404958677684
Zip,27875,North Carolina,NA,38,40,40,118,37,40,40,117,2744419,3796239,7593801,14134459,93595,0.9736842105263158,1,1,0.9915254237288136,0.3162393162393162,0.3418803418803419,0.3418803418803419
Zip,27885,North Carolina,NA,69,65,68,202,69,65,68,202,5366942,6807476,11919454,24093872,102417.5,1,1,1,1,0.3415841584158416,0.3217821782178218,0.33663366336633666
Zip,27889,North Carolina,NA,1609,760,630,2999,183,109,69,361,14940572,15460367,21376345,51777284,113182,0.11373523927905531,0.14342105263157895,0.10952380952380952,0.1203734578192731,0.5069252077562327,0.30193905817174516,0.19113573407202217
Zip,27909,North Carolina,NA,4034,4012,4008,12054,1692,924,1132,3748,128034206,122489295,306625432,557148933,119598.5,0.4194348041646009,0.23030907278165502,0.282435129740519,0.3109341297494608,0.45144076840981856,0.24653148345784417,0.30202774813233724
Zip,27915,North Carolina,NA,66,87,78,231,66,81,66,213,14531341,27905942,38222923,80660206,337171,1,0.9310344827586207,0.8461538461538461,0.922077922077922,0.30985915492957744,0.38028169014084506,0.30985915492957744
Zip,27921,North Carolina,NA,401,395,426,1222,193,139,213,545,28482850,30389892,69928451,128801193,223549,0.48129675810473815,0.3518987341772152,0.5,0.4459901800327332,0.3541284403669725,0.25504587155963304,0.3908256880733945
Zip,27925,North Carolina,NA,81,103,127,311,69,92,102,263,6095025,11104240,23649052,40848317,127562,0.8518518518518519,0.8932038834951457,0.8031496062992126,0.8456591639871383,0.2623574144486692,0.34980988593155893,0.38783269961977185
Zip,27927,North Carolina,NA,427,427,429,1283,120,139,76,335,32348110,71704158,103266729,207318997,478573,0.2810304449648712,0.3255269320843091,0.17715617715617715,0.26110678098207324,0.3582089552238806,0.41492537313432837,0.22686567164179106
Zip,27928,North Carolina,NA,193,172,126,491,104,89,60,253,6384109,7936685,8915665,23236459,76395,0.538860103626943,0.5174418604651163,0.47619047619047616,0.515274949083503,0.41106719367588934,0.35177865612648224,0.23715415019762845
Zip,27929,North Carolina,NA,127,201,200,528,71,117,120,308,14804905,31644099,46932960,93381964,282192,0.5590551181102362,0.582089552238806,0.6,0.5833333333333334,0.2305194805194805,0.37987012987012986,0.38961038961038963
Zip,27932,North Carolina,NA,1233,1216,1190,3639,29,74,215,318,2514296,10402239,77651610,90568145,233019.5,0.023519870235198703,0.06085526315789474,0.18067226890756302,0.08738664468260511,0.09119496855345911,0.23270440251572327,0.6761006289308176
Zip,27936,North Carolina,NA,90,64,53,207,90,64,53,207,15607419,16228892,28119485,59955796,220603,1,1,1,1,0.43478260869565216,0.30917874396135264,0.2560386473429952
Zip,27939,North Carolina,NA,235,249,264,748,106,75,37,218,14597608,14017037,11290461,39905106,160531,0.451063829787234,0.30120481927710846,0.14015151515151514,0.2914438502673797,0.48623853211009177,0.3440366972477064,0.16972477064220184
Zip,27943,North Carolina,NA,81,78,60,219,80,77,55,212,15257753,23746630,35141129,74145512,275700.5,0.9876543209876543,0.9871794871794872,0.9166666666666666,0.9680365296803652,0.37735849056603776,0.3632075471698113,0.25943396226415094
Zip,27944,North Carolina,NA,890,864,912,2666,125,121,171,417,12413574,18141949,55314939,85870462,163918,0.1404494382022472,0.1400462962962963,0.1875,0.15641410352588148,0.2997601918465228,0.290167865707434,0.41007194244604317
Zip,27948,North Carolina,NA,1070,1066,1101,3237,456,496,615,1567,86539710,125407738,246541415,458488863,258063,0.4261682242990654,0.4652908067542214,0.55858310626703,0.48409020698177324,0.2910019144862795,0.31652839821314616,0.39246968730057435
Zip,27949,North Carolina,NA,861,857,1078,2796,271,296,452,1019,76312620,103685286,264634266,444632172,372463,0.3147502903600465,0.3453908984830805,0.41929499072356213,0.3644492131616595,0.26594700686947986,0.2904808635917566,0.4435721295387635
Zip,27950,North Carolina,NA,197,199,198,594,89,98,115,302,14582973,22191323,40404226,77178522,235037.5,0.4517766497461929,0.49246231155778897,0.5808080808080808,0.5084175084175084,0.2947019867549669,0.32450331125827814,0.38079470198675497
Zip,27954,North Carolina,NA,418,431,430,1279,198,188,224,610,38989458,52972968,113276729,205239155,282614,0.47368421052631576,0.4361948955916473,0.5209302325581395,0.4769351055512119,0.32459016393442625,0.3081967213114754,0.36721311475409835
Zip,27958,North Carolina,NA,1107,1087,1103,3297,436,273,392,1101,81058065,72661267,144691816,298411148,257531,0.3938572719060524,0.2511499540018399,0.35539437896645515,0.33393994540491356,0.3960036330608538,0.24795640326975477,0.35603996366939145
Zip,27959,North Carolina,NA,279,270,274,823,48,95,103,246,12294252,30003593,51480742,93778587,345785,0.17204301075268819,0.35185185185185186,0.3759124087591241,0.29890643985419196,0.1951219512195122,0.3861788617886179,0.4186991869918699
Zip,27970,North Carolina,NA,286,283,290,859,13,55,50,118,826344,5778214,11668635,18273193,126014.5,0.045454545454545456,0.19434628975265017,0.1724137931034483,0.13736903376018628,0.11016949152542373,0.4661016949152542,0.423728813559322
Zip,27973,North Carolina,NA,162,142,144,448,64,59,49,172,10757978,13217677,15973573,39949228,224843.5,0.3950617283950617,0.4154929577464789,0.3402777777777778,0.38392857142857145,0.37209302325581395,0.3430232558139535,0.28488372093023256
Zip,27974,North Carolina,NA,126,105,74,305,91,84,63,238,12225426,15301459,21587036,49113921,170765,0.7222222222222222,0.8,0.8513513513513513,0.780327868852459,0.38235294117647056,0.35294117647058826,0.2647058823529412
Zip,27976,North Carolina,NA,274,311,325,910,86,81,75,242,14551074,18441222,22008073,55000369,228144,0.31386861313868614,0.2604501607717042,0.23076923076923078,0.26593406593406593,0.35537190082644626,0.3347107438016529,0.30991735537190085
Zip,28401,North Carolina,NA,5964,1960,1143,9067,59,152,21,232,7541382,30484673,10254998,48281053,195413,0.009892689470154259,0.07755102040816327,0.01837270341207349,0.025587294584757912,0.2543103448275862,0.6551724137931034,0.09051724137931035
Zip,28403,North Carolina,NA,4246,4161,3396,11803,5,56,152,213,634162,12981437,110361758,123977357,356393,0.0011775788977861517,0.013458303292477769,0.0447585394581861,0.01804625942556977,0.023474178403755867,0.26291079812206575,0.7136150234741784
Zip,28405,North Carolina,NA,4481,4323,3775,12579,62,21,57,140,8027169,4519927,54116762,66663858,199639.5,0.01383619727739344,0.004857737682165163,0.015099337748344372,0.011129660545353366,0.44285714285714284,0.15,0.40714285714285714
Zip,28409,North Carolina,NA,2716,4465,6328,13509,127,159,737,1023,19827540,36142034,588317334,644286908,503771,0.046759941089838,0.03561030235162374,0.11646649810366624,0.07572729291583388,0.1241446725317693,0.15542521994134897,0.7204301075268817
Zip,28411,North Carolina,NA,2240,5197,6971,14408,5,25,527,557,711863,6155813,777886023,784753699,1091347,0.002232142857142857,0.004810467577448528,0.07559890976904318,0.03865907828983898,0.008976660682226212,0.04488330341113106,0.9461400359066428
Zip,28412,North Carolina,NA,4540,6450,3341,14331,59,212,405,676,8569064,45565347,189639241,243773652,283883,0.012995594713656388,0.032868217054263564,0.12122119126010177,0.047170469611332075,0.08727810650887574,0.3136094674556213,0.599112426035503
Zip,28422,North Carolina,NA,2670,1519,884,5073,37,21,71,129,3994418,3655346,31695528,39345292,283248,0.013857677902621723,0.013824884792626729,0.08031674208144797,0.0254287403903016,0.2868217054263566,0.16279069767441862,0.5503875968992248
Zip,28428,North Carolina,NA,2356,2365,2397,7118,1093,824,930,2847,191563748,220616870,491048003,903228621,257965,0.4639219015280136,0.3484143763213531,0.3879849812265332,0.3999719022197246,0.3839128907622058,0.2894274675096593,0.3266596417281349
Zip,28443,North Carolina,NA,1445,3099,3304,7848,36,44,226,306,4862939,9109818,110594103,124566860,355156,0.02491349480968858,0.01419812842852533,0.06840193704600485,0.0389908256880734,0.11764705882352941,0.1437908496732026,0.738562091503268
Zip,28445,North Carolina,NA,1995,2379,1948,6322,1066,1126,986,3178,277308355,423084297,567984618,1268377270,362822,0.5343358395989974,0.47330811265237493,0.5061601642710473,0.5026890224612465,0.3354310887350535,0.35431088735053495,0.3102580239144116
Zip,28451,North Carolina,NA,4973,3812,3211,11996,79,66,50,195,10067848,13225686,19818857,43112391,185265,0.015885783229438972,0.017313746065057714,0.015571473061351603,0.016255418472824273,0.40512820512820513,0.3384615384615385,0.2564102564102564
Zip,28457,North Carolina,NA,1183,1183,971,3337,33,42,48,123,2941156,5332784,12162970,20436910,132329,0.027895181741335588,0.03550295857988166,0.04943357363542739,0.03685945459994006,0.2682926829268293,0.34146341463414637,0.3902439024390244
Zip,28460,North Carolina,NA,1538,2546,1969,6053,500,718,926,2144,67038130,163470803,415147989,645656922,249391.5,0.3250975292587776,0.2820109976433621,0.4702894870492636,0.3542045266809846,0.2332089552238806,0.33488805970149255,0.4319029850746269
Zip,28461,North Carolina,NA,3479,3731,3009,10219,131,235,391,757,66468763,144348867,380956187,591773817,670770,0.03765449841908594,0.06298579469311176,0.12994350282485875,0.07407769840493199,0.17305151915455746,0.3104359313077939,0.5165125495376486
Zip,28462,North Carolina,NA,4594,2090,1636,8320,508,560,606,1674,146254660,238097731,412041644,796394035,414539,0.11057901610796692,0.2679425837320574,0.3704156479217604,0.20120192307692308,0.3034647550776583,0.3345280764635603,0.36200716845878134
Zip,28465,North Carolina,NA,2732,2700,2941,8373,77,333,1391,1801,11582541,89886713,626605674,728074928,379204,0.028184480234260616,0.12333333333333334,0.47296837810268616,0.2150961423623552,0.042754025541365905,0.18489727928928373,0.7723486951693503
Zip,28468,North Carolina,NA,1837,1805,1857,5499,20,40,550,610,2655579,9102800,308272359,320030738,468658,0.010887316276537834,0.0221606648199446,0.29617662897145935,0.11092925986543008,0.03278688524590164,0.06557377049180328,0.9016393442622951
Zip,28469,North Carolina,NA,2406,2385,2385,7176,50,819,1391,2260,7307062,241327668,834927640,1083562370,433331,0.020781379883624274,0.3433962264150943,0.5832285115303983,0.3149386845039019,0.022123893805309734,0.36238938053097347,0.6154867256637168
Zip,28470,North Carolina,NA,1808,1815,1836,5459,8,29,73,110,649440,3826731,25040335,29516506,208737.5,0.004424778761061947,0.015977961432506887,0.039760348583877995,0.02015021066129328,0.07272727272727272,0.2636363636363636,0.6636363636363637
Zip,28480,North Carolina,NA,1015,1038,1044,3097,953,904,847,2704,465400075,832033404,1437516379,2734949858,886846.5,0.9389162561576355,0.8709055876685935,0.8113026819923371,0.8731030029060382,0.35244082840236685,0.3343195266272189,0.3132396449704142
Zip,28511,North Carolina,NA,137,137,139,413,42,38,62,142,3670996,4845683,21106936,29623615,145203.5,0.30656934306569344,0.2773722627737226,0.4460431654676259,0.34382566585956414,0.29577464788732394,0.2676056338028169,0.43661971830985913
Zip,28512,North Carolina,NA,2223,2334,2478,7035,872,792,958,2622,134638265,219226134,521691405,875555804,282614,0.3922627080521817,0.3393316195372751,0.38660209846650523,0.37270788912579955,0.3325705568268497,0.30205949656750575,0.36536994660564454
Zip,28515,North Carolina,NA,262,229,171,662,115,99,75,289,7584843,12377727,18791113,38753683,104016,0.4389312977099237,0.43231441048034935,0.43859649122807015,0.43655589123867067,0.39792387543252594,0.34256055363321797,0.25951557093425603
Zip,28516,North Carolina,NA,1939,1941,1941,5821,1145,1018,1187,3350,125679711,198397637,578236557,902313905,192859,0.5905105724600309,0.5244719216898506,0.6115404430705822,0.5755024909809311,0.3417910447761194,0.30388059701492537,0.3543283582089552
Zip,28520,North Carolina,NA,72,73,73,218,42,46,47,135,3465622,6324722,12753915,22544259,134867,0.5833333333333334,0.6301369863013698,0.6438356164383562,0.6192660550458715,0.3111111111111111,0.34074074074074073,0.34814814814814815
Zip,28524,North Carolina,NA,77,80,73,230,77,78,73,228,6800733,10367988,23214065,40382786,122905.5,1,0.975,1,0.991304347826087,0.33771929824561403,0.34210526315789475,0.3201754385964912
Zip,28528,North Carolina,NA,121,107,100,328,83,83,98,264,7723078,13515770,38692042,59930890,167393,0.6859504132231405,0.7757009345794392,0.98,0.8048780487804879,0.3143939393939394,0.3143939393939394,0.3712121212121212
Zip,28531,North Carolina,NA,370,371,333,1074,76,122,249,447,11075189,28034476,125755470,164865135,326146,0.20540540540540542,0.3288409703504043,0.7477477477477478,0.41620111731843573,0.17002237136465326,0.27293064876957496,0.5570469798657718
Zip,28532,North Carolina,NA,2052,2032,1958,6042,42,36,188,266,3692820,4536227,49447020,57676067,178441,0.02046783625730994,0.017716535433070866,0.09601634320735444,0.0440251572327044,0.15789473684210525,0.13533834586466165,0.706766917293233
Zip,28539,North Carolina,NA,1850,1782,1760,5392,13,17,99,129,1452884,2930692,41810507,46194083,293185,0.007027027027027027,0.009539842873176206,0.05625,0.02392433234421365,0.10077519379844961,0.13178294573643412,0.7674418604651163
Zip,28540,North Carolina,NA,4842,4918,4838,14598,79,59,125,263,6882436,7715061,28683361,43280858,146054,0.016315572077653863,0.011996746644977633,0.02583712277800744,0.018016166598164133,0.30038022813688214,0.22433460076045628,0.4752851711026616
Zip,28546,North Carolina,NA,4738,4611,4742,14091,26,25,55,106,2176090,2997110,13721460,18894660,151295.5,0.005487547488391726,0.005421817393190197,0.011598481653310838,0.007522532112696047,0.24528301886792453,0.2358490566037736,0.5188679245283019
Zip,28553,North Carolina,NA,107,107,105,319,103,98,99,300,11155350,15824071,32933271,59912692,158218,0.9626168224299065,0.9158878504672897,0.9428571428571428,0.9404388714733543,0.3433333333333333,0.32666666666666666,0.33
Zip,28556,North Carolina,NA,104,103,105,312,85,81,96,262,9543515,17930076,40309885,67783476,222998.5,0.8173076923076923,0.7864077669902912,0.9142857142857143,0.8397435897435898,0.3244274809160305,0.30916030534351147,0.366412213740458
Zip,28557,North Carolina,NA,2171,2187,2187,6545,333,313,795,1441,46931347,70502752,429262220,546696319,290206,0.15338553661906956,0.14311842706904435,0.3635116598079561,0.22016806722689075,0.23108952116585704,0.21721027064538515,0.5517002081887578
Zip,28560,North Carolina,NA,4193,3249,2622,10064,708,352,442,1502,59377377,54086718,122808105,236272200,131065,0.16885284998807537,0.10834102800861804,0.16857360793287568,0.14924483306836248,0.47137150466045274,0.23435419440745672,0.29427430093209056
Zip,28562,North Carolina,NA,3894,4826,4659,13379,152,255,438,845,14776789,36319919,151143273,202239981,178851,0.03903441191576785,0.05283878988810609,0.09401159047005796,0.06315868151580836,0.17988165680473372,0.30177514792899407,0.5183431952662721
Zip,28570,North Carolina,NA,2915,2932,2076,7923,75,160,322,557,8739692,29869170,146903110,185511972,284400,0.025728987993138937,0.054570259208731244,0.15510597302504817,0.07030165341411082,0.13464991023339318,0.2872531418312388,0.578096947935368
Zip,28571,North Carolina,NA,432,411,422,1265,164,196,274,634,24770909,47463553,116116324,188350786,271260.5,0.37962962962962965,0.4768856447688564,0.6492890995260664,0.5011857707509881,0.2586750788643533,0.30914826498422715,0.43217665615141954
Zip,28577,North Carolina,NA,65,65,68,198,62,65,64,191,5069155,7296097,18565761,30931013,112611,0.9538461538461539,1,0.9411764705882353,0.9646464646464646,0.32460732984293195,0.3403141361256545,0.33507853403141363
Zip,28579,North Carolina,NA,115,109,122,346,115,109,122,346,11150779,16511267,39871109,67533155,155156,1,1,1,1,0.33236994219653176,0.31502890173410403,0.35260115606936415
Zip,28581,North Carolina,NA,45,40,45,130,44,40,45,129,3787246,5241260,12678217,21706723,126040,0.9777777777777777,1,1,0.9923076923076923,0.34108527131782945,0.31007751937984496,0.3488372093023256
Zip,28584,North Carolina,NA,1855,2196,1854,5905,85,172,347,604,10682022,38092220,181964631,230738873,321577,0.04582210242587601,0.07832422586520947,0.1871628910463862,0.1022861981371719,0.14072847682119205,0.2847682119205298,0.5745033112582781
Zip,28587,North Carolina,NA,47,44,44,135,36,42,42,120,1763376,3546466,11486489,16796331,82429.5,0.7659574468085106,0.9545454545454546,0.9545454545454546,0.8888888888888888,0.3,0.35,0.35
Zip,28594,North Carolina,NA,1927,1938,1950,5815,42,177,215,434,10903377,68294879,149386787,228585043,461060,0.021795537104307212,0.0913312693498452,0.11025641025641025,0.07463456577815993,0.0967741935483871,0.4078341013824885,0.49539170506912444
Zip,29401,South Carolina,NA,39,350,3384,3773,28,206,2091,2325,5890345,60718719,2931155256,2997764320,924642,0.717948717948718,0.5885714285714285,0.6179078014184397,0.6162205141796978,0.012043010752688172,0.08860215053763441,0.8993548387096775
Zip,29403,South Carolina,NA,754,1890,3111,5755,259,636,878,1773,52687781,192611394,510475196,755774371,365779,0.34350132625994695,0.33650793650793653,0.28222436515589844,0.30807993049522153,0.1460800902425268,0.3587140439932318,0.4952058657642414
Zip,29405,South Carolina,NA,4208,1259,2497,7964,186,65,436,687,17141661,10950691,147966743,176059095,216853,0.04420152091254753,0.051628276409849086,0.17460953143772526,0.08626318432948267,0.27074235807860264,0.09461426491994178,0.6346433770014556
Zip,29407,South Carolina,NA,4626,4186,2858,11670,546,730,1145,2421,94679807,231613549,760654261,1086947617,358024,0.11802853437094682,0.17439082656473961,0.400629811056683,0.20745501285347043,0.2255266418835192,0.30152829409334986,0.4729450640231309
Zip,29410,South Carolina,NA,1747,1852,2009,5608,61,140,95,296,9623283,28561225,34354318,72538826,207632.5,0.034917000572409845,0.0755939524838013,0.04728720756595321,0.052781740370898715,0.20608108108108109,0.47297297297297297,0.32094594594594594
Zip,29412,South Carolina,NA,4159,6282,4559,15e3,1211,1581,1841,4633,247143203,495798249,1111661649,1854603101,329870,0.29117576340466456,0.2516714422158548,0.40381662645316957,0.3088666666666667,0.26138571120224474,0.34124757176775306,0.39736671703000215
Zip,29414,South Carolina,NA,6402,5060,1188,12650,947,665,418,2030,179772231,201156466,233122104,614050801,250786.5,0.14792252421118401,0.13142292490118576,0.35185185185185186,0.16047430830039525,0.4665024630541872,0.3275862068965517,0.20591133004926107
Zip,29418,South Carolina,NA,1807,2385,2025,6217,42,53,163,258,4595513,8023546,54961359,67580418,206909.5,0.02324294410625346,0.022222222222222223,0.08049382716049383,0.041499115328936784,0.16279069767441862,0.2054263565891473,0.6317829457364341
Zip,29429,South Carolina,NA,321,302,347,970,18,49,149,216,4546336,18413394,136321207,159280937,675851,0.056074766355140186,0.16225165562913907,0.42939481268011526,0.22268041237113403,0.08333333333333333,0.22685185185185186,0.6898148148148148
Zip,29438,South Carolina,NA,970,972,974,2916,712,838,749,2299,171842546,326725068,544687747,1043255361,394095,0.734020618556701,0.8621399176954733,0.768993839835729,0.7884087791495199,0.30969986950848194,0.36450630709003917,0.3257938234014789
Zip,29439,South Carolina,NA,477,629,664,1770,413,422,458,1293,175470633,286244894,543830917,1005546444,667787,0.8658280922431866,0.670906200317965,0.6897590361445783,0.7305084745762712,0.3194122196442382,0.32637277648878577,0.354215003866976
Zip,29440,South Carolina,NA,3044,3050,2978,9072,133,167,904,1204,14394846,24663308,648455742,687513896,486775.5,0.04369250985545335,0.054754098360655735,0.3035594358629953,0.13271604938271606,0.11046511627906977,0.13870431893687707,0.7508305647840532
Zip,29449,South Carolina,NA,853,892,777,2522,91,139,277,507,17770557,50928029,224795056,293493642,485548,0.10668229777256741,0.15582959641255606,0.3564993564993565,0.20103092783505155,0.1794871794871795,0.27416173570019725,0.5463510848126233
Zip,29451,South Carolina,NA,1488,1489,1497,4474,960,944,739,2643,499848812,756249913,1283459916,2539558641,767434,0.6451612903225806,0.6339825386165212,0.49365397461589844,0.5907465355386678,0.36322360953461974,0.35716988270904276,0.2796065077563375
Zip,29455,South Carolina,NA,4989,3576,3885,12450,2188,2106,2570,6864,791011783,1645008418,4743190053,7179210254,658760,0.43856484265383844,0.5889261744966443,0.6615186615186616,0.5513253012048193,0.31876456876456877,0.3068181818181818,0.3744172494172494
Zip,29458,South Carolina,NA,331,328,332,991,33,75,177,285,6396094,20133202,113192191,139721487,393730,0.09969788519637462,0.22865853658536586,0.5331325301204819,0.2875882946518668,0.11578947368421053,0.2631578947368421,0.6210526315789474
Zip,29461,South Carolina,NA,3923,3948,3814,11685,14,91,282,387,1779257,17631913,121898087,141309257,260119,0.0035686974254397143,0.02304964539007092,0.07393812270582066,0.0331193838254172,0.03617571059431524,0.2351421188630491,0.7286821705426356
Zip,29464,South Carolina,NA,5579,5509,6468,17556,696,476,1874,3046,154020279,215734554,1677284591,2047039424,578638.5,0.12475354006094282,0.08640406607369759,0.28973407544836116,0.1735019366598314,0.22849638870650033,0.15627051871306633,0.6152330925804333
Zip,29466,South Carolina,NA,4345,4443,3453,12241,395,1402,2362,4159,122795111,619946951,1885718124,2628460186,561202,0.09090909090909091,0.31555255458023856,0.6840428612800463,0.3397598235438281,0.09497475354652561,0.3371002644866554,0.567924981966819
Zip,29470,South Carolina,NA,359,373,403,1135,28,38,78,144,4202210,9542156,46030978,59775344,344175,0.07799442896935933,0.10187667560321716,0.1935483870967742,0.12687224669603525,0.19444444444444445,0.2638888888888889,0.5416666666666666
Zip,29482,South Carolina,NA,312,318,320,950,261,252,228,741,256537653,430588925,673180119,1360306697,1628483,0.8365384615384616,0.7924528301886793,0.7125,0.78,0.3522267206477733,0.340080971659919,0.3076923076923077
Zip,29487,South Carolina,NA,335,334,329,998,45,64,124,233,8213563,20655010,135104629,163973202,561405,0.13432835820895522,0.19161676646706588,0.3768996960486322,0.23346693386773548,0.19313304721030042,0.27467811158798283,0.5321888412017167
Zip,29488,South Carolina,NA,2738,2697,2707,8142,6,48,67,121,463872,4260432,31388138,36112442,119886,0.002191380569758948,0.017797552836484983,0.024750646472109346,0.014861213461066078,0.049586776859504134,0.39669421487603307,0.5537190082644629
Zip,29492,South Carolina,NA,1160,882,3191,5233,24,61,995,1080,4908548,18410275,875844186,899163009,748037.5,0.020689655172413793,0.0691609977324263,0.31181447821999375,0.20638257213835276,0.022222222222222223,0.05648148148148148,0.9212962962962963
Zip,29526,South Carolina,NA,4969,4759,6086,15814,36,75,141,252,3567461,10320239,35801684,49689384,169019.5,0.007244918494666935,0.015759613364152134,0.02316792638843247,0.015935247249272796,0.14285714285714285,0.2976190476190476,0.5595238095238095
Zip,29527,South Carolina,NA,3166,3466,1642,8274,19,42,64,125,1917595,5803642,14979143,22700380,160702,0.006001263423878711,0.012117714945181766,0.0389768574908648,0.01510756586898719,0.152,0.336,0.512
Zip,29566,South Carolina,NA,3249,3156,3153,9558,11,22,133,166,1298171,3454592,65007814,69760577,301487.5,0.003385657125269314,0.00697084917617237,0.042182048842372345,0.017367650136011718,0.06626506024096386,0.13253012048192772,0.8012048192771084
Zip,29572,South Carolina,NA,3160,2639,3377,9176,281,188,87,556,34468403,35559625,39035124,109063152,147552,0.0889240506329114,0.07123910572186434,0.02576251110453065,0.06059285091543156,0.5053956834532374,0.3381294964028777,0.1564748201438849
Zip,29575,South Carolina,NA,4609,4244,2164,11017,93,151,251,495,12726672,37643095,151146771,201516538,301522,0.02017791277934476,0.03557964184731385,0.11598890942698706,0.04493056185894526,0.18787878787878787,0.30505050505050507,0.5070707070707071
Zip,29576,South Carolina,NA,5554,5863,5843,17260,384,489,1421,2294,49491390,99640854,870249922,1019382166,340493.5,0.06913935902052575,0.08340440047757121,0.24319698784870786,0.13290845886442643,0.16739319965126417,0.21316477768090672,0.6194420226678291
Zip,29577,South Carolina,NA,6172,6367,5005,17544,62,14,26,102,6196200,3144218,15105577,24445995,123694.5,0.010045366169799093,0.002198837757185488,0.005194805194805195,0.005813953488372093,0.6078431372549019,0.13725490196078433,0.2549019607843137
Zip,29582,South Carolina,NA,6401,6600,6821,19822,604,902,1957,3463,75663374,206172470,853508769,1135344613,286765,0.09436025620996719,0.13666666666666666,0.28690807799442897,0.17470487337301988,0.17441524689575513,0.2604678024833959,0.565116950620849
Zip,29585,South Carolina,NA,3405,3437,3576,10418,394,466,1774,2634,65358141,143899895,1248562451,1457820487,497283.5,0.115712187958884,0.13558335757928425,0.4960850111856823,0.25283163755039356,0.14958238420653,0.17691723614274868,0.6735003796507213
Zip,29588,South Carolina,NA,4516,7974,3481,15971,135,235,219,589,14172988,36611909,68569896,119354793,158907,0.029893711248892826,0.029470780035114122,0.0629129560471129,0.036879343810656814,0.22920203735144312,0.398981324278438,0.37181663837011886
Zip,29902,South Carolina,NA,1727,2085,1532,5344,78,262,316,656,11041428,57447186,188812046,257300660,270768,0.0451650260567458,0.12565947242206235,0.206266318537859,0.12275449101796407,0.11890243902439024,0.39939024390243905,0.4817073170731707
Zip,29906,South Carolina,NA,1527,1956,1782,5265,145,137,180,462,20261367,25393869,82081521,127736757,187326,0.09495743287491815,0.07004089979550102,0.10101010101010101,0.08774928774928775,0.31385281385281383,0.29653679653679654,0.38961038961038963
Zip,29907,South Carolina,NA,123,2436,2367,4926,23,167,539,729,3155168,34101866,304778848,342035882,401995,0.18699186991869918,0.06855500821018062,0.22771440642163077,0.14799025578562727,0.03155006858710562,0.22908093278463648,0.7393689986282579
Zip,29909,South Carolina,NA,2976,3458,3792,10226,226,93,349,668,48158890,26254294,219815685,294228869,344589,0.07594086021505377,0.02689415847310584,0.09203586497890295,0.06532368472521025,0.3383233532934132,0.13922155688622753,0.5224550898203593
Zip,29910,South Carolina,NA,4836,4625,4837,14298,98,89,336,523,15171435,25069414,270520375,310761224,427282,0.020264681555004136,0.01924324324324324,0.0694645441389291,0.03657854245349,0.18738049713193117,0.1701720841300191,0.6424474187380497
Zip,29915,South Carolina,NA,46,189,324,559,9,41,125,175,2176747,15707678,115280005,133164430,569918,0.1956521739130435,0.21693121693121692,0.38580246913580246,0.31305903398926654,0.05142857142857143,0.2342857142857143,0.7142857142857143
Zip,29920,South Carolina,NA,1212,1355,2857,5424,426,533,1785,2744,57191161,109316679,943991100,1110498940,380731,0.35148514851485146,0.3933579335793358,0.6247812390619532,0.5058997050147492,0.1552478134110787,0.19424198250728864,0.6505102040816326
Zip,29926,South Carolina,NA,3356,4802,2584,10742,446,513,499,1458,75031726,211434598,495440728,781907052,416392.5,0.132896305125149,0.1068304872969596,0.19311145510835914,0.13572891454105382,0.3058984910836763,0.35185185185185186,0.34224965706447186
Zip,29927,South Carolina,NA,807,784,683,2274,19,88,56,163,2338702,12463475,15636498,30438675,148512,0.023543990086741014,0.11224489795918367,0.08199121522693997,0.07167985927880387,0.1165644171779141,0.5398773006134969,0.34355828220858897
Zip,29928,South Carolina,NA,6367,4770,7028,18165,5048,3542,4791,13381,989616911,1458475215,5512810603,7960902729,397009,0.7928380713051673,0.7425576519916143,0.6817017643710871,0.7366363886595101,0.37725132650773485,0.26470368432852553,0.3580449891637396
Zip,29936,South Carolina,NA,1678,1519,891,4088,9,42,87,138,1173093,6732721,31930117,39835931,228450.5,0.005363528009535161,0.027649769585253458,0.09764309764309764,0.0337573385518591,0.06521739130434782,0.30434782608695654,0.6304347826086957
Zip,29940,South Carolina,NA,419,392,407,1218,101,116,112,329,14578080,21322950,55680709,91581739,180106,0.24105011933174225,0.29591836734693877,0.2751842751842752,0.27011494252873564,0.3069908814589666,0.3525835866261398,0.3404255319148936
Zip,31320,Georgia,NA,1339,1369,384,3092,134,229,51,414,14693608,39341138,16408167,70442913,149298,0.10007468259895444,0.1672753834915997,0.1328125,0.13389391979301424,0.32367149758454106,0.5531400966183575,0.12318840579710146
Zip,31324,Georgia,NA,2872,2877,2878,8627,81,247,480,808,12755465,57426775,186895031,257077271,288115.5,0.028203342618384402,0.08585331942996177,0.16678248783877692,0.09365944128897646,0.10024752475247525,0.3056930693069307,0.594059405940594
Zip,31328,Georgia,NA,786,796,791,2373,705,660,509,1874,223227391,282294487,402201468,907723346,401589.5,0.8969465648854962,0.8291457286432161,0.6434892541087232,0.7897176569742942,0.37620064034151546,0.35218783351120597,0.27161152614727857
Zip,31331,Georgia,NA,465,511,420,1396,14,53,59,126,1309153,10128517,23923109,35360779,261403.5,0.030107526881720432,0.10371819960861056,0.14047619047619048,0.09025787965616046,0.1111111111111111,0.42063492063492064,0.46825396825396826
Zip,31404,Georgia,NA,5606,2458,1160,9224,135,99,47,281,11891890,14534862,20913088,47339840,118052,0.024081341419907244,0.0402766476810415,0.04051724137931034,0.03046400693842151,0.4804270462633452,0.35231316725978645,0.16725978647686832
Zip,31405,Georgia,NA,3292,2825,4408,10525,51,67,73,191,3895156,9743031,26752373,40390560,136767,0.015492102065613609,0.023716814159292034,0.016560798548094374,0.01814726840855107,0.2670157068062827,0.3507853403141361,0.38219895287958117
Zip,31406,Georgia,NA,3192,4368,2835,10395,95,334,802,1231,18048601,75303637,464260953,557613191,353494,0.02976190476190476,0.07646520146520147,0.28289241622574957,0.11842231842231843,0.07717303005686434,0.27132412672623885,0.6515028432168968
Zip,31407,Georgia,NA,1074,1094,1167,3335,66,23,17,106,5629707,3024353,4953842,13607902,90840,0.061452513966480445,0.02102376599634369,0.01456726649528706,0.031784107946026985,0.6226415094339622,0.2169811320754717,0.16037735849056603
Zip,31408,Georgia,NA,841,590,538,1969,31,63,106,200,2338295,7737380,19543957,29619632,136320.5,0.036860879904875146,0.10677966101694915,0.1970260223048327,0.1015744032503809,0.155,0.315,0.53
Zip,31410,Georgia,NA,2548,2678,2660,7886,611,626,1017,2254,114552874,160422904,568416143,843391921,283718,0.23979591836734693,0.2337565347274085,0.3823308270676692,0.28582297742835405,0.27107364685004437,0.2777284826974268,0.45119787045252885
Zip,31411,Georgia,NA,1339,1389,1396,4124,274,479,602,1355,95888498,232574660,513420842,841884e3,540376,0.2046303211351755,0.34485241180705545,0.43123209169054444,0.32856450048496605,0.2022140221402214,0.35350553505535054,0.444280442804428
Zip,31415,Georgia,NA,3431,475,101,4007,305,43,10,358,16383010,5262586,2227889,23873485,51602.5,0.08889536578257068,0.09052631578947369,0.09900990099009901,0.08934364861492389,0.8519553072625698,0.12011173184357542,0.027932960893854747
Zip,31419,Georgia,NA,1166,7082,6276,14524,54,720,521,1295,5771901,94484148,179470196,279726245,142329,0.04631217838765009,0.10166619598983338,0.08301465901848311,0.08916276507849077,0.0416988416988417,0.555984555984556,0.4023166023166023
Zip,31520,Georgia,NA,5295,2298,1030,8623,950,480,384,1814,53284512,54817573,89099307,197201392,85189.5,0.1794145420207743,0.20887728459530025,0.37281553398058254,0.21036762147744403,0.523704520396913,0.26460859977949286,0.21168687982359427
Zip,31522,Georgia,NA,4014,4045,4020,12079,1191,1551,2292,5034,265174159,561177492,1721513970,2547865621,411001,0.296711509715994,0.3834363411619283,0.5701492537313433,0.4167563540028148,0.2365911799761621,0.3081048867699642,0.45530393325387364
Zip,31523,Georgia,NA,1235,1848,3596,6679,124,282,1021,1427,10444096,34363772,266772284,311580152,191076,0.10040485829959514,0.1525974025974026,0.2839265850945495,0.2136547387333433,0.08689558514365803,0.19761737911702873,0.7154870357393133
Zip,31525,Georgia,NA,2091,4469,4009,10569,56,279,479,814,4413926,35077599,115670656,155162181,151697,0.026781444285031087,0.06243007384202282,0.11948116737340983,0.07701769325385562,0.0687960687960688,0.34275184275184273,0.5884520884520884
Zip,31527,Georgia,NA,0,194,751,945,0,32,72,104,0,7000226,31175338,38175564,323905,0,0.16494845360824742,0.09587217043941411,0.11005291005291006,0,0.3076923076923077,0.6923076923076923
Zip,31548,Georgia,NA,1712,1724,1720,5156,26,52,171,249,2737572,8154822,45480719,56373113,215358,0.015186915887850467,0.030162412993039442,0.09941860465116278,0.04829325058184639,0.10441767068273092,0.20883534136546184,0.6867469879518072
Zip,31558,Georgia,NA,1699,1690,1690,5079,154,203,511,868,18349209,32921681,184779500,236050390,234507.5,0.09064155385520895,0.12011834319526628,0.30236686390532547,0.17089978342193346,0.1774193548387097,0.23387096774193547,0.5887096774193549
Zip,31561,Georgia,NA,307,318,355,980,199,245,306,750,245679274,570759811,1126750666,1943189751,2456395,0.6482084690553745,0.7704402515723271,0.8619718309859155,0.7653061224489796,0.2653333333333333,0.32666666666666666,0.408
Zip,31565,Georgia,NA,205,203,213,621,33,29,60,122,3520370,4730496,18160033,26410899,190235,0.16097560975609757,0.14285714285714285,0.28169014084507044,0.1964573268921095,0.27049180327868855,0.23770491803278687,0.4918032786885246
Zip,31569,Georgia,NA,494,513,505,1512,47,48,85,180,5060968,8111649,24440625,37613242,187786.5,0.0951417004048583,0.0935672514619883,0.16831683168316833,0.11904761904761904,0.2611111111111111,0.26666666666666666,0.4722222222222222
Zip,32003,Florida,NA,3334,3337,3336,10007,100,287,554,941,18826356,72870004,345165348,436861708,362086,0.029994001199760048,0.08600539406652682,0.16606714628297362,0.09403417607674627,0.10626992561105207,0.30499468650371947,0.5887353878852285
Zip,32034,Florida,NA,5582,5722,5827,17131,695,485,1025,2205,108477818,162144618,788596018,1059218454,384700,0.12450734503762093,0.0847605732261447,0.1759052685773125,0.12871402720214814,0.31519274376417233,0.2199546485260771,0.46485260770975056
Zip,32043,Florida,NA,2600,4161,1949,8710,47,111,234,392,4852664,22110962,105510075,132473701,306337.5,0.018076923076923077,0.026676279740447006,0.12006157003591586,0.045005740528128585,0.11989795918367346,0.28316326530612246,0.5969387755102041
Zip,32068,Florida,NA,6598,6965,5359,18922,60,179,252,491,6597327,28336116,95542030,130475473,188814,0.009093664746892998,0.025699928212491025,0.047023698451203584,0.025948631222915124,0.12219959266802444,0.3645621181262729,0.5132382892057027
Zip,32073,Florida,NA,4367,4968,3907,13242,31,16,109,156,3459263,2743374,54131652,60334289,254382.5,0.007098694756125487,0.00322061191626409,0.02789864346045559,0.011780697779791573,0.1987179487179487,0.10256410256410256,0.6987179487179487
Zip,32080,Florida,NA,3863,4026,5837,13726,1882,1772,2411,6065,349287247,521277229,1348084585,2218649061,305819,0.4871861247734921,0.4401390958768008,0.41305465136200104,0.44186215940550777,0.3103050288540808,0.2921681780708986,0.3975267930750206
Zip,32082,Florida,NA,4703,4525,4584,13812,1432,2639,2526,6597,326748890,1333178222,2742457223,4402384335,561423,0.30448649798001276,0.5832044198895028,0.5510471204188482,0.47762814943527365,0.21706836440806426,0.4000303168106715,0.3829013187812642
Zip,32084,Florida,NA,6903,3166,1938,12007,1110,1290,1146,3546,190206428,343942966,641026519,1175175913,261543.5,0.16079965232507606,0.4074542008843967,0.5913312693498453,0.29532772549346215,0.31302876480541453,0.3637901861252115,0.32318104906937395
Zip,32086,Florida,NA,3403,5150,2269,10822,27,27,56,110,3273329,5741992,26388802,35404123,283920,0.007934175727299441,0.005242718446601942,0.0246804759806082,0.010164479763444834,0.24545454545454545,0.24545454545454545,0.509090909090909
Zip,32092,Florida,NA,1940,4600,5490,12030,173,87,340,600,22314394,20285241,169720317,212319952,329042,0.08917525773195877,0.01891304347826087,0.061930783242258654,0.04987531172069826,0.28833333333333333,0.145,0.5666666666666667
Zip,32095,Florida,NA,1370,494,1826,3690,415,128,76,619,42197484,27448918,32664773,102311175,124511,0.3029197080291971,0.2591093117408907,0.0416210295728368,0.16775067750677508,0.6704361873990307,0.20678513731825526,0.12277867528271405
Zip,32097,Florida,NA,2346,2211,2106,6663,119,95,204,418,12368887,20572054,61609300,94550241,215685,0.050724637681159424,0.04296698326549073,0.09686609686609686,0.06273450397718745,0.284688995215311,0.22727272727272727,0.4880382775119617
Zip,32102,Florida,NA,531,535,545,1611,2,108,202,312,125080,13778237,56457806,70361123,195104.5,0.003766478342749529,0.20186915887850468,0.3706422018348624,0.19366852886405958,0.00641025641025641,0.34615384615384615,0.6474358974358975
Zip,32112,Florida,NA,1237,1218,1196,3651,10,59,196,265,367696,3785930,42358279,46511905,142977,0.008084074373484237,0.048440065681444995,0.16387959866220736,0.07258285401259928,0.03773584905660377,0.22264150943396227,0.7396226415094339
Zip,32114,Florida,NA,3575,2670,1025,7270,1785,695,238,2718,107670964,81068110,64602943,253342017,68193,0.4993006993006993,0.2602996254681648,0.23219512195121952,0.3738651994497937,0.6567328918322296,0.2557027225901398,0.0875643855776306
Zip,32117,Florida,NA,4046,2358,1911,8315,791,560,948,2299,52183347,61863026,247220785,361267158,117177,0.19550173010380623,0.23748939779474132,0.49607535321821034,0.2764882742032471,0.34406263592866465,0.2435841670291431,0.41235319704219225
Zip,32118,Florida,NA,4148,4969,5018,14135,22,157,117,296,1800323,19923133,82483012,104206468,135833.5,0.005303760848601736,0.03159589454618635,0.023316062176165803,0.020940926777502655,0.07432432432432433,0.5304054054054054,0.3952702702702703
Zip,32119,Florida,NA,1998,2291,2788,7077,637,790,968,2395,48531528,115419652,255734174,419685354,155902,0.3188188188188188,0.3448275862068966,0.3472022955523673,0.3384202345626678,0.2659707724425887,0.3298538622129436,0.40417536534446763
Zip,32127,Florida,NA,4121,4660,3520,12301,986,702,769,2457,130484789,171875203,397542558,699902550,208277,0.23926231497209416,0.15064377682403435,0.2184659090909091,0.1997398585480855,0.4013024013024013,0.2857142857142857,0.312983312983313
Zip,32129,Florida,NA,2832,2056,858,5746,121,128,54,303,14450630,24270924,15830742,54552296,177164,0.042725988700564974,0.0622568093385214,0.06293706293706294,0.0527323355377654,0.39933993399339934,0.42244224422442245,0.1782178217821782
Zip,32131,Florida,NA,673,680,652,2005,32,78,182,292,1679577,8804974,55159972,65644523,197891.5,0.0475482912332838,0.11470588235294117,0.2791411042944785,0.1456359102244389,0.1095890410958904,0.2671232876712329,0.6232876712328768
Zip,32132,Florida,NA,1322,613,843,2778,145,11,160,316,14156790,1657344,85721208,101535342,173336.5,0.10968229954614221,0.01794453507340946,0.18979833926453143,0.11375089992800576,0.4588607594936709,0.03481012658227848,0.5063291139240507
Zip,32136,Florida,NA,1285,1299,1442,4026,550,624,646,1820,100977040,169783101,337706428,608466569,291224.5,0.4280155642023346,0.48036951501154734,0.44798890429958393,0.4520615996025832,0.3021978021978022,0.34285714285714286,0.35494505494505496
Zip,32137,Florida,NA,5518,4911,10666,21095,140,182,1452,1774,18894385,39017248,762184455,820096088,374930,0.025371511417180137,0.03705966198330279,0.13613350834427151,0.08409575728845697,0.07891770011273957,0.10259301014656144,0.818489289740699
Zip,32139,Florida,NA,238,289,239,766,22,22,66,110,901147,1432230,13830338,16163715,122530,0.09243697478991597,0.07612456747404844,0.27615062761506276,0.14360313315926893,0.2,0.2,0.6
Zip,32141,Florida,NA,1984,2665,2431,7080,96,127,317,540,10355179,19725137,116522986,146603302,191524,0.04838709677419355,0.04765478424015009,0.13039901275195392,0.07627118644067797,0.17777777777777778,0.2351851851851852,0.587037037037037
Zip,32145,Florida,NA,660,656,642,1958,94,133,88,315,6758736,12939516,16589248,36287500,95795,0.14242424242424243,0.2027439024390244,0.13707165109034267,0.16087844739530133,0.2984126984126984,0.4222222222222222,0.27936507936507937
Zip,32168,Florida,NA,4975,2876,2286,10137,2392,886,613,3891,338332212,208238408,320728321,867298941,179473,0.4808040201005025,0.30806675938803896,0.26815398075240593,0.3838413731873335,0.6147519917758931,0.22770496016448213,0.15754304805962477
Zip,32169,Florida,NA,1047,3101,5717,9865,306,726,1544,2576,49588679,185967906,832442363,1067998948,308765,0.2922636103151863,0.23411802644308288,0.2700717159349309,0.2611251900658895,0.1187888198757764,0.28183229813664595,0.5993788819875776
Zip,32174,Florida,NA,5337,5099,6957,17393,1097,597,514,2208,161043823,123671652,280069975,564785450,180235.5,0.20554618699643995,0.11708178074132183,0.07388242058358488,0.12694762260679585,0.49682971014492755,0.2703804347826087,0.23278985507246377
Zip,32176,Florida,NA,2786,3357,3111,9254,32,55,329,416,5347364,11733527,269736914,286817805,606071.5,0.01148600143575018,0.016383675901102176,0.10575377692060431,0.04495353360708883,0.07692307692307693,0.13221153846153846,0.7908653846153846
Zip,32177,Florida,NA,3277,3289,3276,9842,61,75,240,376,3029518,6719133,64456165,74204816,184239,0.018614586512053707,0.022803283672848892,0.07326007326007326,0.038203617150985573,0.1622340425531915,0.19946808510638298,0.6382978723404256
Zip,32189,Florida,NA,1094,1098,1098,3290,84,245,383,712,3311040,15104477,51073127,69488644,77583,0.07678244972577697,0.22313296903460839,0.348816029143898,0.21641337386018236,0.11797752808988764,0.3441011235955056,0.5379213483146067
Zip,32193,Florida,NA,263,316,314,893,6,124,162,292,381796,15470129,32739653,48591578,137972,0.022813688212927757,0.3924050632911392,0.5159235668789809,0.3269876819708847,0.02054794520547945,0.4246575342465753,0.5547945205479452
Zip,32202,Florida,NA,710,201,140,1051,98,3,0,101,5936340,405325,0,6341665,52330,0.13802816901408452,0.014925373134328358,0,0.0960989533777355,0.9702970297029703,0.0297029702970297,0
Zip,32204,Florida,NA,485,569,927,1981,17,93,181,291,1626233,13389496,85672355,100688084,244126,0.03505154639175258,0.1634446397188049,0.19525350593311758,0.1468955073195356,0.058419243986254296,0.31958762886597936,0.6219931271477663
Zip,32205,Florida,NA,4268,2677,2970,9915,7,45,222,274,726311,6647204,180635566,188009081,354743.5,0.0016401124648547328,0.016809861785580874,0.07474747474747474,0.027634896621280887,0.025547445255474453,0.16423357664233576,0.8102189781021898
Zip,32207,Florida,NA,3814,3945,3941,11700,59,176,799,1034,6146702,27320096,345063511,378530309,279118,0.01546932354483482,0.04461343472750317,0.20274042121289013,0.08837606837606837,0.05705996131528046,0.1702127659574468,0.7727272727272727
Zip,32208,Florida,NA,10026,1838,561,12425,745,277,345,1367,64543424,41895e3,93742674,200181098,113791,0.07430680231398364,0.15070729053318824,0.6149732620320856,0.11002012072434608,0.5449890270665692,0.20263350402340893,0.25237746891002194
Zip,32209,Florida,NA,12207,530,85,12822,146,85,11,242,8423819,12123445,2437289,22984553,68034,0.011960350618497583,0.16037735849056603,0.12941176470588237,0.018873810637965997,0.6033057851239669,0.3512396694214876,0.045454545454545456
Zip,32210,Florida,NA,10109,5709,3668,19486,321,275,796,1392,27996666,42385487,424906222,495288375,221429.5,0.03175388267880107,0.04816955684007707,0.21701199563794984,0.07143590269937392,0.23060344827586207,0.19755747126436782,0.5718390804597702
Zip,32211,Florida,NA,4072,4160,990,9222,20,54,117,191,2160256,8329799,44579972,55070027,229425,0.004911591355599214,0.012980769230769231,0.11818181818181818,0.020711342441986552,0.10471204188481675,0.28272251308900526,0.612565445026178
Zip,32216,Florida,NA,3014,6154,2427,11595,11,64,198,273,1181074,10054927,58557089,69793090,237430,0.0036496350364963502,0.010399740006499838,0.0815822002472188,0.02354463130659767,0.040293040293040296,0.23443223443223443,0.7252747252747253
Zip,32217,Florida,NA,1011,2438,2882,6331,175,52,199,426,12303764,7896948,97286731,117487443,171823,0.17309594460929772,0.02132895816242822,0.06904927133934767,0.06728794819143895,0.4107981220657277,0.12206572769953052,0.4671361502347418
Zip,32218,Florida,NA,5315,7577,5489,18381,135,393,341,869,12681497,62833129,98702561,174217187,175376,0.02539981185324553,0.051867493731028114,0.06212424849699399,0.04727707959305805,0.15535097813578827,0.4522439585730725,0.3924050632911392
Zip,32223,Florida,NA,195,2366,6848,9409,0,2,515,517,0,315164,287732471,288047635,372731,0,8.453085376162299e-4,0.07520443925233646,0.05494739079604634,0,0.0038684719535783366,0.9961315280464217
Zip,32224,Florida,NA,1013,1549,8671,11233,18,101,677,796,2248275,14917181,298129387,315294843,372123.5,0.017769002961500493,0.06520335700451904,0.07807634644216353,0.07086263687349773,0.022613065326633167,0.12688442211055276,0.8505025125628141
Zip,32225,Florida,NA,1834,5053,11404,18291,4,35,536,575,360166,5726628,217387344,223474138,324693,0.0021810250817884407,0.0069265782703344545,0.04700105226236408,0.03143622546607621,0.006956521739130435,0.06086956521739131,0.9321739130434783
Zip,32226,Florida,NA,523,1726,3965,6214,47,122,786,955,4623342,19196924,323753381,347573647,317398,0.08986615678776291,0.07068366164542295,0.19823455233291298,0.15368522690698422,0.049214659685863874,0.12774869109947645,0.8230366492146597
Zip,32233,Florida,NA,2379,2830,1854,7063,405,513,231,1149,64850070,137442520,140227154,342519744,205232,0.17023959646910466,0.1812720848056537,0.12459546925566344,0.1626787484071924,0.3524804177545692,0.4464751958224543,0.2010443864229765
Zip,32244,Florida,NA,5523,11433,1394,18350,97,51,45,193,7552965,7905042,17330048,32788055,111310,0.017562918703603114,0.004460771451062713,0.032281205164992825,0.010517711171662125,0.5025906735751295,0.26424870466321243,0.23316062176165803
Zip,32250,Florida,NA,3291,3493,4570,11354,944,481,1317,2742,145959967,171883980,691790213,1009634160,342194,0.28684290489213005,0.13770397938734613,0.28818380743982497,0.24150079267218602,0.34427425237053244,0.17541940189642596,0.4803063457330416
Zip,32258,Florida,NA,255,3170,7509,10934,0,8,98,106,0,1162945,36710951,37873896,317322.5,0,0.002523659305993691,0.013051005460114529,0.009694530821291385,0,0.07547169811320754,0.9245283018867925
Zip,32259,Florida,NA,3498,4258,7189,14945,9,19,166,194,1925299,5877129,122547310,130349738,621527.5,0.002572898799313894,0.004462188821042743,0.023090833217415497,0.012980930076948812,0.04639175257731959,0.0979381443298969,0.8556701030927835
Zip,32266,Florida,NA,744,760,763,2267,87,127,131,345,22657836,49607426,81858400,154123662,409338,0.11693548387096774,0.16710526315789473,0.17169069462647443,0.1521835024261138,0.25217391304347825,0.3681159420289855,0.37971014492753624
Zip,32277,Florida,NA,1537,4393,2303,8233,0,39,384,423,0,6824226,132059807,138884033,256227,0,0.008877760072843159,0.16673903603994789,0.051378598323818775,0,0.09219858156028368,0.9078014184397163
Zip,32320,Florida,NA,493,510,495,1498,12,37,93,142,1681001,5611559,33916620,41209180,244612.5,0.02434077079107505,0.07254901960784314,0.18787878787878787,0.09479305740987984,0.08450704225352113,0.2605633802816901,0.6549295774647887
Zip,32322,Florida,NA,599,635,536,1770,31,83,160,274,3800711,13246461,58372851,75420023,240785,0.05175292153589316,0.13070866141732285,0.29850746268656714,0.15480225988700566,0.11313868613138686,0.3029197080291971,0.583941605839416
Zip,32327,Florida,NA,3203,3187,3151,9541,97,198,422,717,8008481,25624953,119717030,153350464,188841,0.030284108648142367,0.06212739253216191,0.1339257378609965,0.07514935541347867,0.13528591352859135,0.27615062761506276,0.5885634588563459
Zip,32328,Florida,NA,856,876,881,2613,86,376,412,874,23584256,166170727,376211919,565966902,574988.5,0.10046728971962617,0.4292237442922374,0.4676503972758229,0.3344814389590509,0.09839816933638444,0.4302059496567506,0.47139588100686497
Zip,32346,Florida,NA,564,604,617,1785,188,320,295,803,18154377,67429697,130345101,215929175,237824,0.3333333333333333,0.5298013245033113,0.47811993517017826,0.44985994397759105,0.23412204234122042,0.398505603985056,0.36737235367372356
Zip,32348,Florida,NA,1763,1501,1517,4781,118,90,487,695,5751523,8897549,131939455,146588527,170188,0.06693136698808849,0.05996002664890073,0.3210283454185893,0.14536707801715124,0.16978417266187051,0.12949640287769784,0.7007194244604317
Zip,32358,Florida,NA,356,339,425,1120,22,29,61,112,1681187,3711245,21859542,27251974,169552,0.06179775280898876,0.0855457227138643,0.14352941176470588,0.1,0.19642857142857142,0.25892857142857145,0.5446428571428571
Zip,32359,Florida,NA,262,293,316,871,37,82,121,240,2237223,7892245,29832729,39962197,116949.5,0.14122137404580154,0.27986348122866894,0.3829113924050633,0.2755453501722158,0.15416666666666667,0.3416666666666667,0.5041666666666667
Zip,32401,Florida,NA,5330,2258,1153,8741,196,108,132,436,15517989,18967997,52397408,86883394,149022.5,0.03677298311444653,0.047829937998228524,0.11448395490026018,0.049879876444342754,0.44954128440366975,0.24770642201834864,0.30275229357798167
Zip,32404,Florida,NA,4158,4731,4271,13160,56,137,493,686,5370883,21146223,154162326,180679432,212165,0.013468013468013467,0.028957937011202705,0.11542964177007727,0.052127659574468084,0.08163265306122448,0.19970845481049562,0.7186588921282799
Zip,32405,Florida,NA,2868,3416,2912,9196,21,182,242,445,1965011,31347371,113999347,147311729,236502,0.007322175732217573,0.05327868852459016,0.0831043956043956,0.04839060461070031,0.04719101123595506,0.40898876404494383,0.5438202247191011
Zip,32407,Florida,NA,2963,2797,2066,7826,276,153,107,536,31328222,34264771,54156450,119749443,175046.5,0.0931488356395545,0.05470146585627458,0.05179090029041626,0.06848964988499873,0.5149253731343284,0.28544776119402987,0.19962686567164178
Zip,32408,Florida,NA,2827,5605,6832,15264,230,613,894,1737,23978273,112410297,376380976,512769546,237511,0.08135833038556774,0.10936663693131132,0.13085480093676816,0.11379716981132075,0.13241220495106507,0.35290731145653426,0.5146804835924007
Zip,32409,Florida,NA,1837,1037,809,3683,65,66,128,259,5671200,12403374,48766627,66841201,256173,0.035383777898747956,0.06364513018322084,0.15822002472187885,0.0703231061634537,0.25096525096525096,0.2548262548262548,0.4942084942084942
Zip,32413,Florida,NA,4973,5987,6802,17762,178,433,359,970,23476518,100343798,166525500,290345816,244876,0.03579328373215363,0.07232336729580759,0.05277859453102029,0.05461096723341966,0.18350515463917524,0.4463917525773196,0.37010309278350517
Zip,32439,Florida,NA,1265,1288,1307,3860,103,154,228,485,9562797,28301500,89436761,127301058,228086,0.08142292490118577,0.11956521739130435,0.17444529456771232,0.12564766839378239,0.21237113402061855,0.31752577319587627,0.47010309278350515
Zip,32444,Florida,NA,2405,2410,2510,7325,116,164,438,718,15109905,33422298,166680297,215212500,268225,0.048232848232848236,0.06804979253112033,0.1745019920318725,0.09802047781569966,0.1615598885793872,0.22841225626740946,0.6100278551532033
Zip,32456,Florida,NA,2255,2338,2355,6948,233,272,529,1034,30656180,64370856,295139688,390166724,315105,0.1033259423503326,0.11633875106929,0.22462845010615712,0.14881980426021876,0.2253384912959381,0.26305609284332687,0.511605415860735
Zip,32459,Florida,NA,4662,4259,4004,12925,855,372,225,1452,173447175,175737896,322872145,672057216,280578.5,0.1833976833976834,0.0873444470532989,0.05619380619380619,0.1123404255319149,0.5888429752066116,0.256198347107438,0.15495867768595042
Zip,32506,Florida,NA,4337,4748,2934,12019,2,26,177,205,137892,3692194,61083317,64913403,282274,4.611482591653217e-4,0.005475989890480202,0.06032719836400818,0.017056327481487644,0.00975609756097561,0.12682926829268293,0.8634146341463415
Zip,32507,Florida,NA,4041,2772,9435,16248,126,229,1870,2225,9777617,31953262,666593907,708324786,270664,0.031180400890868598,0.08261183261183261,0.1981981981981982,0.13693993106843919,0.05662921348314607,0.10292134831460674,0.8404494382022472
Zip,32541,Florida,NA,5067,5061,5044,15172,561,332,450,1343,104867305,112437841,418869868,636175014,312686,0.11071640023682652,0.06559968385694527,0.08921490880253767,0.0885183232269971,0.4177215189873418,0.24720774385703648,0.33507073715562175
Zip,32547,Florida,NA,3210,3305,4259,10774,65,36,147,248,5718311,5976911,72434307,84129529,269543,0.020249221183800622,0.010892586989409985,0.03451514440009392,0.023018377575645073,0.2620967741935484,0.14516129032258066,0.592741935483871
Zip,32548,Florida,NA,3e3,4239,4059,11298,81,407,591,1079,10241950,78675665,256576470,345494085,266688,0.027,0.09601321066289219,0.14560236511456023,0.09550362896087804,0.07506950880444857,0.37720111214087115,0.5477293790546802
Zip,32550,Florida,NA,3919,3995,4037,11951,218,264,381,863,54274124,100197542,418608012,573079678,425506,0.05562643531513141,0.06608260325406759,0.09437701263314342,0.07221153041586478,0.2526071842410197,0.30590961761297797,0.44148319814600234
Zip,32561,Florida,NA,528,1878,3481,5887,118,722,1790,2630,19353552,196946719,1081556999,1297857270,462033,0.22348484848484848,0.3844515441959531,0.514220051709279,0.4467470698148463,0.044866920152091254,0.27452471482889734,0.6806083650190115
Zip,32563,Florida,NA,4564,3175,1623,9362,150,319,439,908,25392099,89397023,256387299,371176421,338484.5,0.03286590709903593,0.10047244094488189,0.270486752926679,0.09698782311471908,0.16519823788546256,0.3513215859030837,0.4834801762114537
Zip,32566,Florida,NA,5127,5141,5120,15388,146,217,480,843,23202001,47578029,215791655,286571685,283734,0.028476692022625316,0.042209686831355765,0.09375,0.05478294775149467,0.17319098457888493,0.25741399762752076,0.5693950177935944
Zip,32569,Florida,NA,1579,1584,1588,4751,0,1,129,130,0,170444,69645102,69815546,532357,0,6.313131313131314e-4,0.08123425692695214,0.02736266049252789,0,0.007692307692307693,0.9923076923076923
Zip,32578,Florida,NA,4239,4238,4244,12721,37,66,348,451,6150155,18494541,209468517,234113213,469690,0.008728473696626562,0.01557338367154318,0.08199811498586239,0.035453187642480934,0.082039911308204,0.14634146341463414,0.7716186252771619
Zip,32579,Florida,NA,1357,1367,1376,4100,164,59,147,370,17233473,15411679,86373689,119018841,261885,0.1208548268238762,0.04316020482809071,0.1068313953488372,0.09024390243902439,0.44324324324324327,0.15945945945945947,0.3972972972972973
Zip,32583,Florida,NA,2958,3034,2667,8659,70,83,567,720,5989296,11443925,172969076,190402297,231569.5,0.023664638269100743,0.027356624917600526,0.2125984251968504,0.08315047927012358,0.09722222222222222,0.11527777777777778,0.7875
Zip,32625,Florida,NA,389,391,398,1178,86,183,246,515,9837099,38642878,90975638,139455615,267406,0.2210796915167095,0.4680306905370844,0.6180904522613065,0.4371816638370119,0.1669902912621359,0.3553398058252427,0.47766990291262135
Zip,32626,Florida,NA,1601,963,648,3212,47,49,23,119,4547704,10061037,6704781,21313522,176623,0.029356652092442224,0.05088265835929388,0.035493827160493825,0.03704856787048568,0.3949579831932773,0.4117647058823529,0.19327731092436976
Zip,32628,Florida,NA,825,757,733,2315,137,218,193,548,11574085,28090796,47531396,87196277,138235.5,0.16606060606060605,0.28797886393659183,0.26330150068212826,0.2367170626349892,0.25,0.3978102189781022,0.3521897810218978
Zip,32648,Florida,NA,120,118,138,376,71,101,130,302,5285688,14539162,34673414,54498264,163676,0.5916666666666667,0.8559322033898306,0.9420289855072463,0.8031914893617021,0.23509933774834438,0.3344370860927152,0.4304635761589404
Zip,32680,Florida,NA,1692,1007,1004,3703,99,98,131,328,8395594,12534863,32052243,52982700,127906.5,0.05851063829787234,0.09731876861966236,0.13047808764940239,0.08857682959762354,0.3018292682926829,0.29878048780487804,0.39939024390243905
Zip,32720,Florida,NA,3944,3289,3284,10517,32,43,97,172,3311374,7060075,34291822,44663271,226247,0.008113590263691683,0.01307388263910003,0.02953714981729598,0.01635447370923267,0.18604651162790697,0.25,0.563953488372093
Zip,32759,Florida,NA,427,456,462,1345,35,101,129,265,2723465,13950392,35982180,52656037,165273,0.08196721311475409,0.22149122807017543,0.2792207792207792,0.1970260223048327,0.1320754716981132,0.38113207547169814,0.4867924528301887
Zip,32780,Florida,NA,5314,4879,5575,15768,11,39,58,108,778496,4902658,25542979,31224133,193799,0.0020700037636432068,0.007993441278950604,0.010403587443946188,0.00684931506849315,0.10185185185185185,0.3611111111111111,0.5370370370370371
Zip,32796,Florida,NA,2635,3103,2353,8091,41,1,218,260,2728263,109459,80201958,83039680,325247.5,0.01555977229601518,3.222687721559781e-4,0.09264768380790481,0.032134470399209,0.1576923076923077,0.0038461538461538464,0.8384615384615385
Zip,32903,Florida,NA,925,1390,4360,6675,0,1,239,240,0,442523,249700587,250143110,930568,0,7.194244604316547e-4,0.05481651376146789,0.035955056179775284,0,0.004166666666666667,0.9958333333333333
Zip,32905,Florida,NA,6154,1409,1726,9289,28,3,178,209,1983380,453139,66031885,68468404,326971,0.004549886252843679,0.0021291696238466998,0.10312862108922363,0.022499730864463344,0.1339712918660287,0.014354066985645933,0.8516746411483254
Zip,32920,Florida,NA,2282,2233,2255,6770,655,416,313,1384,60893047,84954977,124970687,270818711,161739,0.28702892199824714,0.18629646215853113,0.13880266075388026,0.20443131462333824,0.47326589595375723,0.30057803468208094,0.22615606936416185
Zip,32931,Florida,NA,3298,3307,3298,9903,1399,1379,1891,4669,251606178,408870405,1103651564,1764128147,324798,0.42419648271679805,0.4169942546114303,0.5733778047301394,0.47147329092194284,0.2996358963375455,0.29535232383808097,0.40501177982437353
Zip,32935,Florida,NA,5844,6365,2519,14728,100,6,86,192,7378952,1011984,57373258,65764194,120109,0.017111567419575632,9.426551453260016e-4,0.034140531957125846,0.013036393264530146,0.5208333333333334,0.03125,0.4479166666666667
Zip,32937,Florida,NA,3843,3957,4198,11998,1205,983,1647,3835,257846680,298988052,1065384535,1622219267,328393,0.31355711683580534,0.24842052059641143,0.3923296808003811,0.31963660610101685,0.31421121251629724,0.2563233376792699,0.42946544980443285
Zip,32949,Florida,NA,253,329,384,966,75,21,56,152,15839494,7186724,34626818,57653036,303858.5,0.2964426877470356,0.06382978723404255,0.14583333333333334,0.15734989648033126,0.4934210526315789,0.13815789473684212,0.3684210526315789
Zip,32951,Florida,NA,2184,2186,2202,6572,549,410,745,1704,94314800,153722440,520635771,768673011,415337,0.25137362637362637,0.18755718206770358,0.3383287920072661,0.2592818015824711,0.3221830985915493,0.24061032863849766,0.43720657276995306
Zip,32952,Florida,NA,2804,2922,3227,8953,1144,885,1433,3462,124248957,232395784,993382528,1350027269,286062.5,0.4079885877318117,0.3028747433264887,0.44406569569259374,0.3866860270300458,0.3304448295782785,0.255632582322357,0.41392258809936455
Zip,32953,Florida,NA,3115,2996,2699,8810,581,616,733,1930,60509678,164878884,364856119,590244681,288375,0.18651685393258427,0.205607476635514,0.2715820674323824,0.21906923950056753,0.3010362694300518,0.31917098445595854,0.3797927461139896
Zip,32955,Florida,NA,5839,4868,4415,15122,41,73,276,390,6370735,14972749,185979494,207322978,504757.5,0.007021750299708854,0.014995891536565324,0.06251415628539071,0.02579023938632456,0.10512820512820513,0.18717948717948718,0.7076923076923077
Zip,32958,Florida,NA,4056,4029,4006,12091,99,52,211,362,13853104,9364028,105657545,128874677,257334,0.02440828402366864,0.012906428394142468,0.0526709935097354,0.0299396245141014,0.27348066298342544,0.143646408839779,0.5828729281767956
Zip,32960,Florida,NA,3822,2966,874,7662,1317,284,393,1994,134693431,55373108,242031028,432097567,112968,0.3445839874411303,0.09575185434929198,0.4496567505720824,0.2602453667449752,0.660481444332999,0.1424272818455366,0.19709127382146438
Zip,32962,Florida,NA,6738,3937,969,11644,2339,465,228,3032,184423402,92158126,101002798,377584326,82521,0.3471356485604037,0.11811023622047244,0.23529411764705882,0.26039161800068705,0.7714379947229552,0.15336411609498682,0.07519788918205805
Zip,32963,Florida,NA,1296,1849,8305,11450,257,490,2262,3009,87649716,280305584,2577183138,2945138438,577831,0.19830246913580246,0.2650081124932396,0.272366044551475,0.2627947598253275,0.08541043536058492,0.16284479893652376,0.7517447657028913
Zip,32967,Florida,NA,2044,3636,3296,8976,49,97,314,460,6468634,20315325,167584825,194368784,283478,0.023972602739726026,0.02667766776677668,0.09526699029126214,0.05124777183600713,0.10652173913043478,0.2108695652173913,0.6826086956521739
Zip,33001,Florida,NA,136,132,137,405,136,132,136,404,26537803,35955662,80976252,143469717,260454,1,1,0.9927007299270073,0.9975308641975309,0.33663366336633666,0.32673267326732675,0.33663366336633666
Zip,33004,Florida,NA,1893,1461,1915,5269,1451,992,1588,4031,189843675,178810004,540986844,909640523,177913,0.7665081880612784,0.6789869952087612,0.829242819843342,0.7650408047067755,0.3599603076159762,0.24609278094765566,0.3939469114363682
Zip,33009,Florida,NA,7597,7685,7823,23105,6607,5914,5112,17633,833692078,1223250864,2366449045,4423391987,192164,0.8696854021324207,0.7695510735198439,0.6534577527802633,0.7631681454230685,0.3746951738218114,0.33539386377814323,0.2899109624000454
Zip,33010,Florida,NA,686,3077,2777,6540,410,1072,1350,2832,52016086,267622177,433919186,753557449,277239.5,0.597667638483965,0.34839129021774456,0.48613611811307167,0.43302752293577984,0.14477401129943504,0.3785310734463277,0.4766949152542373
Zip,33012,Florida,NA,7393,3479,6650,17522,4860,2169,2034,9063,629886129,474818082,661213212,1765917423,156846,0.6573786013796835,0.6234550158091405,0.30586466165413534,0.5172354754023514,0.5362462760675273,0.23932472691161866,0.22442899702085403
Zip,33013,Florida,NA,297,3121,3871,7289,179,401,519,1099,24799029,100414875,161578135,286792039,276454,0.6026936026936027,0.12848446010893944,0.13407388271764403,0.15077514062285635,0.16287534121929026,0.364877161055505,0.47224749772520475
Zip,33014,Florida,NA,4440,3075,2639,10154,2364,699,184,3247,401050703,168105231,97596837,666752771,177954,0.5324324324324324,0.22731707317073171,0.06972338006820765,0.31977545794760687,0.7280566676932553,0.2152756390514321,0.056667693255312596
Zip,33015,Florida,NA,4715,5366,7275,17356,3279,2034,1451,6764,424178744,381883790,506957256,1313019790,155846,0.6954400848356309,0.3790532985464033,0.19945017182130584,0.38972113390182067,0.48477232406859844,0.3007096392667061,0.21451803666469543
Zip,33016,Florida,NA,7453,3246,2004,12703,5826,1994,964,8784,831989314,476744734,540850223,1849584271,147313,0.7816986448410036,0.6142945163277881,0.4810379241516966,0.6914901991655514,0.6632513661202186,0.22700364298724954,0.10974499089253188
Zip,33018,Florida,NA,1725,5807,5433,12965,1057,2158,1794,5009,165515417,543069019,680327834,1388912270,274069,0.6127536231884058,0.37162045806784916,0.33020430701270015,0.38634785962205936,0.21102016370533042,0.43082451587143145,0.35815532042323817
Zip,33019,Florida,NA,787,2936,8022,11745,659,1946,5940,8545,97909056,527215800,4083310787,4708435643,382923,0.8373570520965693,0.6628065395095368,0.7404637247569185,0.7275436355896125,0.07712112346401405,0.22773551784669396,0.695143358689292
Zip,33020,Florida,NA,6397,3336,1575,11308,1486,1232,1309,4027,186419907,308348283,513761890,1008530080,234496,0.23229638893231203,0.36930455635491605,0.8311111111111111,0.3561195613724797,0.3690091879811274,0.3059349391606655,0.3250558728582071
Zip,33021,Florida,NA,6446,3507,6364,16317,1199,1572,1307,4078,166050779,413146736,617594670,1196792185,267746,0.18600682593856654,0.4482463644140291,0.2053739786297926,0.24992339278053563,0.2940166748406081,0.3854830799411476,0.3205002452182442
Zip,33023,Florida,NA,7852,8041,1579,17472,2909,3543,79,6531,563746888,875168597,19829469,1458744954,236738,0.3704788588894549,0.440616838701654,0.050031665611146296,0.3737980769230769,0.4454141785331496,0.5424896646761599,0.012096156790690553
Zip,33024,Florida,NA,5810,12578,2448,20836,4159,6840,1680,12679,650991299,1842204735,780573274,3273769308,244293,0.7158347676419966,0.5438066465256798,0.6862745098039216,0.6085141101938952,0.32802271472513606,0.5394747219812288,0.13250256329363513
Zip,33025,Florida,NA,11124,6951,1244,19319,8704,4141,679,13524,1268706344,1188906511,397639522,2855252377,183444,0.7824523552678893,0.5957416199108042,0.5458199356913184,0.7000362337595114,0.6435965690624076,0.3061963916001183,0.05020703933747412
Zip,33026,Florida,NA,4492,4378,3023,11893,3313,3790,2084,9187,534124395,1052183892,889610116,2475918403,241614,0.73753339269813,0.8656920968478757,0.6893814091961628,0.7724712015471286,0.36061826493958854,0.4125394579296833,0.22684227713072821
Zip,33027,Florida,NA,8867,5089,10114,24070,6315,3910,6403,16628,786826751,1163361723,2822331829,4772520303,304411.5,0.7121912710048495,0.7683238357241108,0.633082855447894,0.6908184461985875,0.3797810921337503,0.23514553764734183,0.38507337021890786
Zip,33029,Florida,NA,572,3093,10887,14552,1,882,2798,3681,228329,283593813,1367386413,1651208555,421859,0.0017482517482517483,0.2851600387972842,0.2570037659594011,0.25295492028587135,2.7166530834012495e-4,0.2396088019559902,0.7601195327356697
Zip,33030,Florida,NA,1130,2761,2239,6130,381,23,62,466,41002956,3717348,31948910,76669214,108409,0.33716814159292036,0.00833031510322347,0.027690933452434122,0.07601957585644371,0.8175965665236051,0.04935622317596566,0.13304721030042918
Zip,33032,Florida,NA,3166,4827,3359,11352,745,1133,778,2656,142063658,242674286,218330645,603068589,218297,0.23531269740998104,0.23472135902216698,0.23161655254540042,0.2339675828047921,0.2804969879518072,0.4265813253012048,0.29292168674698793
Zip,33033,Florida,NA,3720,6051,6011,15782,1350,2589,2625,6564,161682384,491561586,664709897,1317953867,200964.5,0.3629032258064516,0.42786316311353495,0.43669938446182,0.4159168673171968,0.2056672760511883,0.3944241316270567,0.399908592321755
Zip,33034,Florida,NA,1672,880,1003,3555,1071,241,283,1595,103565797,37307636,89274558,230147991,104995,0.6405502392344498,0.27386363636363636,0.28215353938185445,0.44866385372714485,0.671473354231975,0.15109717868338557,0.1774294670846395
Zip,33035,Florida,NA,3623,1114,1128,5865,2652,414,254,3320,301273135,75683289,69093446,446049870,116208.5,0.7319900634833011,0.37163375224416517,0.225177304964539,0.566069906223359,0.7987951807228916,0.1246987951807229,0.07650602409638554
Zip,33036,Florida,NA,964,980,992,2936,491,752,873,2116,190901561,627495126,1594949399,2413346086,951011,0.5093360995850622,0.7673469387755102,0.8800403225806451,0.720708446866485,0.23204158790170132,0.3553875236294896,0.41257088846880907
Zip,33037,Florida,NA,3075,3055,3056,9186,1620,1959,2142,5721,456662474,1039899840,3556097806,5052660120,566421,0.526829268292683,0.6412438625204583,0.7009162303664922,0.6227955584585239,0.2831672784478238,0.34242265338227584,0.37441006816990036
Zip,33040,Florida,NA,3410,3456,3690,10556,3206,2972,2997,9175,1247411625,1785026183,3479406152,6511843960,566143,0.9401759530791789,0.8599537037037037,0.8121951219512196,0.8691739295187572,0.34942779291553133,0.32392370572207085,0.3266485013623978
Zip,33042,Florida,NA,1444,1450,1447,4341,1442,1433,1382,4257,497925731,807744606,1498161607,2803831944,555870,0.9986149584487535,0.9882758620689656,0.9550794747753973,0.9806496199032481,0.3387361992013155,0.3366220342964529,0.32464176650223164
Zip,33043,Florida,NA,870,867,869,2606,854,865,861,2580,249012122,368281109,646096442,1263389673,420268,0.9816091954022989,0.9976931949250288,0.9907940161104718,0.990023023791251,0.3310077519379845,0.33527131782945735,0.33372093023255817
Zip,33050,Florida,NA,1705,1706,1736,5147,1613,1632,1561,4806,433552833,809690183,1888295335,3131538351,486105,0.9460410557184751,0.9566236811254396,0.8991935483870968,0.9337478142607344,0.33562213899292553,0.33957553058676654,0.3248023304203079
Zip,33051,Florida,NA,410,387,383,1180,401,385,374,1160,146680049,224848961,479030485,850559495,560198,0.9780487804878049,0.9948320413436692,0.9765013054830287,0.9830508474576272,0.3456896551724138,0.33189655172413796,0.32241379310344825
Zip,33054,Florida,NA,3190,2063,1668,6921,1602,855,482,2939,220069379,148528296,112290686,480888361,157939,0.5021943573667712,0.4144449830344159,0.28896882494004794,0.42464961710735444,0.5450833616876488,0.29091527730520583,0.1640013610071453
Zip,33055,Florida,NA,3384,3042,4340,10766,1249,1046,1142,3437,194729219,231322798,313575519,739627536,223048,0.3690898345153664,0.3438527284681131,0.2631336405529954,0.31924577373211965,0.36339831248181553,0.3043351760256037,0.33226651149258074
Zip,33056,Florida,NA,2532,3837,2543,8912,1774,1340,712,3826,251875221,282392295,189268237,723535753,199650.5,0.7006319115323855,0.3492311701850404,0.2799842705465985,0.42930879712746856,0.46366962885520124,0.35023523261892314,0.1860951385258756
Zip,33060,Florida,NA,2767,2122,4107,8996,2005,418,3307,5730,212741708,83047302,1398831850,1694620860,286468.5,0.724611492591254,0.19698397737983034,0.8052106160214269,0.6369497554468653,0.349912739965096,0.07294938917975567,0.5771378708551483
Zip,33062,Florida,NA,3380,5267,10581,19228,1497,2750,4227,8474,234231307,648883517,2664189216,3547304040,289224.5,0.4428994082840237,0.5221188532371369,0.3994896512616955,0.4407114624505929,0.17665801274486664,0.32452206750059004,0.4988199197545433
Zip,33064,Florida,NA,6201,9905,2805,18911,579,951,1242,2772,85320112,468669990,1753589760,2307579862,603712,0.09337203676826318,0.09601211509338718,0.44278074866310163,0.1465813547670668,0.20887445887445888,0.3430735930735931,0.44805194805194803
Zip,33069,Florida,NA,6976,4249,947,12172,257,38,3,298,30329919,6658514,925361,37913794,119188,0.03684059633027523,0.00894328077194634,0.0031678986272439284,0.02448241866579034,0.8624161073825504,0.12751677852348994,0.010067114093959731
Zip,33070,Florida,NA,986,990,985,2961,803,688,875,2366,250906636,349185667,1037819809,1637912112,517814,0.8144016227180527,0.694949494949495,0.8883248730964467,0.7990543735224587,0.3393913778529163,0.2907861369399831,0.3698224852071006
Zip,33125,Florida,NA,3681,4653,550,8884,2307,1961,226,4494,370103572,583623329,116412513,1070139414,250026.5,0.6267318663406682,0.42144852783150655,0.4109090909090909,0.5058532192705988,0.513351134846462,0.436359590565198,0.05028927458834001
Zip,33126,Florida,NA,4926,5015,1752,11693,3875,3123,935,7933,560949149,685085659,280446366,1526481174,164144,0.7866423061307348,0.6227318045862412,0.533675799086758,0.6784400923629522,0.48846590192865247,0.3936720030253372,0.11786209504601033
Zip,33128,Florida,NA,471,64,36,571,268,44,21,333,37968251,13242926,14419476,65630653,137040,0.5690021231422505,0.6875,0.5833333333333334,0.5831873905429071,0.8048048048048048,0.13213213213213212,0.06306306306306306
Zip,33129,Florida,NA,485,2008,4048,6541,24,162,338,524,5764956,46939168,252897930,305602054,452252,0.049484536082474224,0.08067729083665338,0.08349802371541502,0.08011007491209295,0.04580152671755725,0.30916030534351147,0.6450381679389313
Zip,33130,Florida,NA,2804,2906,1533,7243,971,1199,870,3040,172727275,373890541,457178826,1003796642,289845,0.3462910128388017,0.41259463179628353,0.5675146771037182,0.4197155874637581,0.3194078947368421,0.3944078947368421,0.28618421052631576
Zip,33131,Florida,NA,2509,5241,7114,14864,923,3507,4291,8721,201939147,1124921678,3849423106,5176283931,389939,0.36787564766839376,0.6691471093302804,0.6031768344110205,0.5867195909580194,0.1058364866414402,0.4021327829377365,0.4920307304208233
Zip,33132,Florida,NA,1034,2751,3494,7279,217,1316,1830,3363,46941461,403938646,1406800835,1857680942,429595,0.20986460348162475,0.47837150127226463,0.5237550085861477,0.4620140129138618,0.06452572108236694,0.3913172762414511,0.54415700267618194
Zip,33133,Florida,NA,2197,1911,8052,12160,481,42,1181,1704,146582926,31016544,2278519828,2456119298,859818.5,0.21893491124260356,0.02197802197802198,0.1466716343765524,0.1401315789473684,0.2822769953051643,0.02464788732394366,0.693075117370892
Zip,33136,Florida,NA,1388,198,86,1672,235,120,65,420,42147736,36558606,50451413,129157755,232069.5,0.16930835734870317,0.6060606060606061,0.7558139534883721,0.2511961722488038,0.5595238095238095,0.2857142857142857,0.15476190476190477
Zip,33137,Florida,NA,2883,2075,3067,8025,702,1108,1376,3186,148893548,341791093,1299146944,1789831585,359475,0.24349635796045785,0.5339759036144578,0.44864688620802085,0.3970093457943925,0.22033898305084745,0.3477715003138732,0.43188951663527936
Zip,33138,Florida,NA,1802,2327,4019,8148,754,425,1679,2858,154218422,156660524,1576499996,1887378942,485185,0.4184239733629301,0.1826385904598195,0.4177656133366509,0.35076092292587135,0.2638208537438768,0.14870538838348496,0.5874737578726382
Zip,33139,Florida,NA,8448,7606,7323,23377,8123,5776,5882,19781,1834878480,2255853812,12716717319,16807449611,340592,0.9615293560606061,0.7594004733105443,0.8032227229277619,0.8461735894255037,0.4106465800515646,0.29199737121480207,0.2973560487336333
Zip,33140,Florida,NA,2381,6446,6097,14924,2113,2961,3821,8895,465254492,1216975034,9661448479,11343678005,479463,0.8874422511549769,0.4593546385355259,0.6267016565524028,0.5960198338247119,0.23754918493535696,0.33288364249578417,0.4295671725688589
Zip,33141,Florida,NA,6499,3383,4144,14026,6155,2782,3008,11945,1154123318,1018391263,4615839225,6788353806,256283,0.9470687798122788,0.8223470292639669,0.7258687258687259,0.8516326821616997,0.5152783591460862,0.23290079531184596,0.2518208455420678
Zip,33142,Florida,NA,5743,2182,1385,9310,646,474,118,1238,113473171,118279523,54353966,286106660,214897,0.1124847640605955,0.21723189734188816,0.0851985559566787,0.13297529538131042,0.5218093699515347,0.38287560581583197,0.09531502423263329
Zip,33143,Florida,NA,3625,2544,5361,11530,1197,155,414,1766,194100004,53617568,821624495,1069342067,188106,0.33020689655172414,0.06092767295597484,0.07722439843312814,0.15316565481352992,0.6778029445073612,0.08776896942242356,0.23442808607021517
Zip,33144,Florida,NA,1686,2885,1459,6030,91,111,540,742,20612802,41071757,262724257,324408816,389439.5,0.05397390272835113,0.03847487001733102,0.3701165181631254,0.1230514096185738,0.12264150943396226,0.1495956873315364,0.7277628032345014
Zip,33147,Florida,NA,3426,3433,3525,10384,305,303,374,982,38804970,54198122,91979365,184982457,184019,0.0890251021599533,0.08826099621322459,0.10609929078014184,0.09456856702619415,0.3105906313645621,0.3085539714867617,0.38085539714867617
Zip,33149,Florida,NA,2290,2297,2306,6893,1684,1723,1247,4654,965641121,2100252875,4994093869,8059987865,1084896,0.7353711790393013,0.7501088376142795,0.5407632263660017,0.6751777165240098,0.36183927804039534,0.3702191663085518,0.2679415556510529
Zip,33150,Florida,NA,2995,1674,693,5362,705,309,263,1277,103968502,65677602,88177834,257823938,161409,0.2353923205342237,0.18458781362007168,0.3795093795093795,0.2381574039537486,0.5520751761942052,0.24197337509788566,0.20595144870790916
Zip,33154,Florida,NA,2970,2972,2972,8914,1864,2097,1802,5763,731765660,1354381100,4767401568,6853548328,631584,0.6276094276094276,0.705585464333782,0.6063257065948856,0.6465111061251964,0.3234426513968419,0.36387298282144714,0.31268436578171094
Zip,33155,Florida,NA,3677,5040,5233,13950,360,510,362,1232,109516535,177919245,176812774,464248554,346954,0.09790590155017677,0.10119047619047619,0.06917638066118861,0.08831541218637994,0.2922077922077922,0.413961038961039,0.29383116883116883
Zip,33156,Florida,NA,3103,3659,4704,11466,117,78,295,490,23156646,78988942,952138686,1054284274,1495811,0.037705446342249434,0.0213172998086909,0.0627125850340136,0.042735042735042736,0.23877551020408164,0.15918367346938775,0.6020408163265306
Zip,33157,Florida,NA,6141,6149,6465,18755,390,404,347,1141,100994934,170864781,207898259,479757974,323133,0.0635075720566683,0.06570174012034477,0.05367362722351121,0.060837110103972275,0.3418054338299737,0.3540753724802805,0.3041191936897458
Zip,33158,Florida,NA,93,871,1388,2352,93,57,133,283,33529648,34179053,104802350,172511051,598976,1,0.06544202066590127,0.09582132564841499,0.12032312925170068,0.3286219081272085,0.20141342756183744,0.46996466431095407
Zip,33160,Florida,NA,10704,7756,9389,27849,9718,5889,3565,19172,2171651159,2751455852,5081094623,10004201634,268357,0.9078849028400597,0.7592831356369263,0.37969964852486954,0.6884268734963553,0.5068850406843313,0.3071667014395994,0.18594825787606928
Zip,33161,Florida,NA,3517,2713,4779,11009,1878,808,2293,4979,229910164,201416788,765361156,1196688108,245238,0.5339778220073926,0.2978252856616292,0.4798074911069261,0.4522663275501862,0.37718417352882105,0.1622815826471179,0.46053424382406105
Zip,33162,Florida,NA,3355,4273,3843,11471,1241,153,614,2008,122999437,31892484,245676911,400568832,120359,0.3698956780923994,0.035806225134565876,0.15977101223002863,0.17505012640571876,0.6180278884462151,0.07619521912350598,0.3057768924302789
Zip,33165,Florida,NA,4841,5303,5207,15351,265,337,270,872,55468015,110601856,136219643,302289514,326285,0.05474075604214006,0.06354893456534037,0.05185327443825619,0.056804116995635465,0.3038990825688073,0.38646788990825687,0.30963302752293576
Zip,33166,Florida,NA,3410,1540,1542,6492,2344,1276,1112,4732,499477179,475906391,582199315,1557582885,327705,0.6873900293255132,0.8285714285714286,0.7211413748378729,0.7288971041281578,0.49535080304311074,0.2696534234995773,0.23499577345731193
Zip,33167,Florida,NA,1405,1874,1041,4320,119,250,347,716,16980547,48347919,95711019,161039485,202895.5,0.08469750889679716,0.13340448239060831,0.3333333333333333,0.16574074074074074,0.16620111731843576,0.34916201117318435,0.48463687150837986
Zip,33168,Florida,NA,1913,3682,897,6492,65,228,139,432,10147734,46738490,43118601,100004825,215064,0.03397804495556717,0.061922868006518195,0.15496098104793757,0.066543438077634,0.15046296296296297,0.5277777777777778,0.32175925925925924
Zip,33169,Florida,NA,2858,3134,3579,9571,1620,666,1306,3592,177519274,138633596,447419723,763572593,200151.5,0.5668299510146956,0.21250797702616464,0.36490639843531714,0.37530038658447396,0.4510022271714922,0.18541202672605792,0.36358574610244987
Zip,33170,Florida,NA,853,678,1859,3390,143,76,122,341,22783153,16790493,41375542,80949188,216135,0.16764361078546308,0.11209439528023599,0.0656266810112964,0.10058997050147493,0.41935483870967744,0.22287390029325513,0.35777126099706746
Zip,33172,Florida,NA,4377,4028,2591,10996,1929,1112,957,3998,284079168,211334303,294098991,789512462,161410,0.4407128169979438,0.27606752730883816,0.3693554612118873,0.3635867588213896,0.4824912456228114,0.27813906953476736,0.23936968484242122
Zip,33173,Florida,NA,3884,4930,1923,10737,604,828,297,1729,139813510,249592459,160849304,550255273,290382,0.15550978372811536,0.16795131845841785,0.1544461778471139,0.161031945608643,0.3493348756506651,0.47888953152111047,0.1717755928282244
Zip,33174,Florida,NA,2772,1745,3744,8261,797,720,2346,3863,118338339,167351980,684505699,970196018,246729,0.2875180375180375,0.41260744985673353,0.6266025641025641,0.4676189323326474,0.2063163344550867,0.18638363965829666,0.6073000258866166
Zip,33175,Florida,NA,3329,5035,7812,16176,723,309,786,1818,114408130,100670081,519092773,734170984,328854.5,0.2171823370381496,0.061370407149950346,0.10061443932411675,0.1123887240356083,0.3976897689768977,0.16996699669966997,0.43234323432343236
Zip,33176,Florida,NA,5930,3647,7899,17476,196,108,78,382,27710489,25822818,28357936,81891243,158169,0.03305227655986509,0.029613380860981628,0.009874667679453095,0.021858548867017623,0.5130890052356021,0.28272251308900526,0.20418848167539266
Zip,33177,Florida,NA,4973,5032,4452,14457,134,114,22,270,28075450,26162878,6718288,60956616,223890.5,0.026945505730947113,0.022655007949125595,0.004941599281221923,0.01867607387424777,0.4962962962962963,0.4222222222222222,0.08148148148148149
Zip,33178,Florida,NA,4120,5717,5624,15461,2043,1542,1183,4768,476931788,477354692,600926393,1555212873,279769,0.49587378640776697,0.2697218821059997,0.21034850640113797,0.3083888493629131,0.4284815436241611,0.3234060402684564,0.24811241610738255
Zip,33179,Florida,NA,5877,4824,4667,15368,4417,2099,1907,8423,378640720,271942993,1016643920,1667227633,111235,0.7515739322783733,0.4351160862354892,0.40861367045211056,0.5480869338885996,0.5243974830820373,0.24919862281847321,0.2264038940994895
Zip,33180,Florida,NA,4513,7163,6481,18157,4231,5206,3925,13362,882769497,1826463350,3190790640,5900023487,337074,0.9375138488810104,0.726790450928382,0.6056164172195648,0.7359145233243377,0.31664421493788353,0.38961233348301155,0.2937434515791049
Zip,33181,Florida,NA,2238,1475,2651,6364,1959,1296,1913,5168,247811822,246320807,1629849454,2123982083,184748,0.8753351206434317,0.8786440677966102,0.7216144850999623,0.8120678818353237,0.37906346749226005,0.25077399380804954,0.3701625386996904
Zip,33182,Florida,NA,690,1874,1423,3987,54,38,79,171,11828846,11602874,58344771,81776491,320439,0.0782608695652174,0.020277481323372464,0.05551651440618412,0.04288939051918736,0.3157894736842105,0.2222222222222222,0.4619883040935672
Zip,33184,Florida,NA,1932,988,2496,5416,0,180,144,324,0,57306822,79614829,136921651,338421,0,0.18218623481781376,0.057692307692307696,0.05982274741506647,0,0.5555555555555556,0.4444444444444444
Zip,33187,Florida,NA,544,1106,3366,5016,0,2,108,110,0,461461,49773543,50235004,417420,0,0.0018083182640144665,0.03208556149732621,0.021929824561403508,0,0.01818181818181818,0.9818181818181818
Zip,33189,Florida,NA,2441,2668,2026,7135,345,115,417,877,45349324,31686466,141192475,218228265,293687,0.14133551823023352,0.04310344827586207,0.2058242843040474,0.12291520672740014,0.3933865450399088,0.13112884834663627,0.475484606613455
Zip,33190,Florida,NA,2131,657,1026,3814,335,106,319,760,54528558,19991917,98142861,172663336,212903.5,0.15720319099014546,0.1613394216133942,0.310916179337232,0.19926586261143156,0.4407894736842105,0.1394736842105263,0.41973684210526313
Zip,33301,Florida,NA,662,2265,4083,7010,389,1998,3219,5606,72955095,634741339,4715802383,5423498817,503314.5,0.5876132930513596,0.8821192052980132,0.7883908890521675,0.7997146932952924,0.06938993935069568,0.3564038530146272,0.5742062076346771
Zip,33304,Florida,NA,1873,2500,2910,7283,1442,1958,1905,5305,249419912,588079751,1852519891,2690019554,308132,0.7698878804057662,0.7832,0.654639175257732,0.7284086228202664,0.27181903864278983,0.36908576814326105,0.3590951932139491
Zip,33305,Florida,NA,1236,1328,2698,5262,1166,1138,1664,3968,188845078,365632920,1477898158,2032376156,352203.5,0.9433656957928802,0.8569277108433735,0.6167531504818384,0.7540858988977575,0.2938508064516129,0.2867943548387097,0.41935483870967744
Zip,33306,Florida,NA,551,382,902,1835,456,375,750,1581,70650706,108361273,645324646,824336625,364233,0.8275862068965517,0.981675392670157,0.8314855875831486,0.8615803814713896,0.2884250474383302,0.23719165085388993,0.47438330170777987
Zip,33308,Florida,NA,5760,6528,8130,20418,3027,2746,2608,8381,467483266,856686331,2939522405,4263692002,272891,0.5255208333333333,0.4206495098039216,0.3207872078720787,0.41047115290430014,0.3611740842381577,0.32764586564849063,0.31118005011335165
Zip,33309,Florida,NA,3860,4426,3605,11891,1929,652,1168,3749,212795645,114838873,344548541,672183059,135641,0.49974093264248703,0.1473113420695888,0.32399445214979194,0.3152804642166344,0.5145372099226461,0.17391304347826086,0.31154974659909307
Zip,33311,Florida,NA,8875,4361,3200,16436,3507,1342,559,5408,511287520,335884134,196853173,1044024827,165891,0.3951549295774648,0.30772758541618894,0.1746875,0.3290338281820394,0.6484837278106509,0.2481508875739645,0.10336538461538461
Zip,33312,Florida,NA,4727,6537,3172,14436,1883,3960,2533,8376,273625231,1075741325,1120445172,2469811728,268376.5,0.3983499048022001,0.6057824690224873,0.7985498108448928,0.5802161263507897,0.22480897803247374,0.47277936962750716,0.3024116523400191
Zip,33313,Florida,NA,9488,5755,2455,17698,922,338,38,1298,73862052,71502195,10467184,155831431,83736.5,0.09717537942664418,0.058731537793223286,0.015478615071283095,0.07334162052209289,0.7103235747303543,0.26040061633281975,0.029275808936825885
Zip,33314,Florida,NA,2568,1912,624,5104,2019,1633,479,4131,266689961,420547458,252813561,940050980,188463,0.7862149532710281,0.8540794979079498,0.7676282051282052,0.8093652037617555,0.4887436456063907,0.3953038005325587,0.11595255386105059
Zip,33315,Florida,NA,1354,2343,776,4473,1214,2068,735,4017,209176250,633601236,421830459,1264607945,284924,0.896602658788774,0.8826291079812206,0.9471649484536082,0.898054996646546,0.30221558376898183,0.5148120487926313,0.18297236743838685
Zip,33316,Florida,NA,1351,1398,3545,6294,803,716,1844,3363,141271317,202955379,2729724199,3073950895,486701,0.5943745373797187,0.5121602288984263,0.5201692524682652,0.5343183984747378,0.23877490336009516,0.21290514421647339,0.5483199524234315
Zip,33317,Florida,NA,3177,4500,4384,12061,744,663,1602,3009,90826112,200502394,720110775,1011439281,387093,0.23418319169027385,0.14733333333333334,0.3654197080291971,0.249481800845701,0.2472582253240279,0.22033898305084745,0.5324027916251246
Zip,33319,Florida,NA,6510,9004,5085,20599,299,502,21,822,15231891,33476215,4216314,52924420,60534,0.04592933947772657,0.055752998667258996,0.004129793510324484,0.03990484974998786,0.3637469586374696,0.610705596107056,0.025547445255474453
Zip,33322,Florida,NA,10542,4087,4460,19089,599,65,74,738,64821127,16293213,26754014,107868354,121612.5,0.05682033769683172,0.015904086126743332,0.016591928251121078,0.03866100895803866,0.8116531165311653,0.08807588075880758,0.1002710027100271
Zip,33324,Florida,NA,8549,4701,3e3,16250,4382,690,356,5428,577428908,189982819,263450065,1030861792,151160,0.5125745701251608,0.1467772814294831,0.11866666666666667,0.33403076923076924,0.8072955047899779,0.1271186440677966,0.0655858511422255
Zip,33325,Florida,NA,740,3897,3097,7734,253,516,572,1341,33434214,109039828,356259774,498733816,325754,0.3418918918918919,0.13240954580446498,0.18469486599935422,0.1733902249806051,0.18866517524235646,0.38478747203579416,0.42654735272184935
Zip,33326,Florida,NA,5196,3526,3049,11771,1332,88,66,1486,259675601,38337261,73221748,371234610,190222.5,0.25635103926096997,0.024957458876914352,0.02164644145621515,0.1262424602837482,0.8963660834454913,0.059219380888290714,0.04441453566621804
Zip,33328,Florida,NA,2656,3870,3237,9763,2577,2662,1964,7203,567538063,879923956,1084756826,2532218845,343328,0.9702560240963856,0.6878552971576227,0.6067346308310164,0.7377855167469015,0.3577675968346522,0.36956823545744827,0.2726641677078995
Zip,33330,Florida,NA,770,1253,2761,4784,64,18,484,566,16286497,7032583,392032251,415351331,691763.5,0.08311688311688312,0.014365522745411013,0.1752988047808765,0.11831103678929766,0.11307420494699646,0.03180212014134275,0.8551236749116607
Zip,33331,Florida,NA,1250,2511,3554,7315,13,34,200,247,3854457,14837078,176714266,195405801,872549,0.0104,0.013540422142572681,0.056274620146314014,0.033766233766233764,0.05263157894736842,0.13765182186234817,0.8097165991902834
Zip,33334,Florida,NA,2466,3221,4085,9772,2163,2103,3108,7374,231009722,526938721,1261864526,2019812969,235694,0.8771289537712895,0.6529028252095622,0.7608323133414933,0.7546049938600082,0.2933279088689992,0.28519121236777867,0.42148087876322216
Zip,33401,Florida,NA,3955,4041,4022,12018,59,198,567,824,8983793,45611086,598105423,652700302,419739.5,0.014917825537294564,0.04899777282850779,0.14097463948284436,0.06856382093526377,0.07160194174757281,0.24029126213592233,0.6881067961165048
Zip,33403,Florida,NA,1855,1175,881,3911,159,241,71,471,19980396,49678276,30937848,100596520,199332,0.08571428571428572,0.2051063829787234,0.08059023836549375,0.12042955765788801,0.3375796178343949,0.5116772823779193,0.15074309978768577
Zip,33404,Florida,NA,5249,3483,5180,13912,103,520,1150,1773,14772114,133188873,889983558,1037944545,379932,0.019622785292436655,0.14929658340511054,0.222007722007722,0.12744393329499712,0.0580936266215454,0.29328821206993794,0.6486181613085167
Zip,33405,Florida,NA,850,3226,2425,6501,104,105,566,775,12150938,24318858,605111706,641581502,458555,0.1223529411764706,0.03254804711717297,0.2334020618556701,0.1192124288570989,0.13419354838709677,0.13548387096774195,0.7303225806451613
Zip,33407,Florida,NA,4041,3888,1518,9447,106,406,183,695,14909312,83195488,179785880,277890680,204168,0.02623113090819104,0.1044238683127572,0.12055335968379446,0.07356832856991638,0.15251798561151078,0.5841726618705037,0.2633093525179856
Zip,33408,Florida,NA,3680,3657,3707,11044,858,673,878,2409,162432977,227386472,1697319415,2087138864,338375,0.23315217391304346,0.18403062619633578,0.23684920420825464,0.21812749003984064,0.3561643835616438,0.27936903279369035,0.36446658364466583
Zip,33410,Florida,NA,4780,5123,3688,13591,75,423,562,1060,17409405,154229287,764169437,935808129,458130,0.015690376569037656,0.08256880733944955,0.15238611713665945,0.07799278934589066,0.07075471698113207,0.39905660377358493,0.530188679245283
Zip,33428,Florida,NA,6531,5609,2497,14637,119,0,1,120,10010070,0,463364,10473434,85223,0.01822079314040729,0,4.0048057669203043e-4,0.00819840131174421,0.9916666666666667,0,0.008333333333333333
Zip,33431,Florida,NA,1398,3353,3023,7774,67,400,268,735,13677739,121396223,438752765,573826727,338782,0.04792560801144492,0.11929615269907545,0.0886536553092954,0.09454592230511963,0.09115646258503401,0.54421768707483,0.36462585034013606
Zip,33432,Florida,NA,2308,2038,6323,10669,677,251,1102,2030,138071064,74877703,1557107421,1770056188,488577.5,0.29332755632582325,0.12315996074582924,0.17428435869049502,0.19027087824538383,0.3334975369458128,0.12364532019704433,0.5428571428571428
Zip,33435,Florida,NA,9332,3724,2857,15913,2709,1001,966,4676,355692814,351732312,867708688,1575133814,160422,0.29029147021003,0.26879699248120303,0.33811690584529225,0.29384779739835354,0.5793413173652695,0.21407185628742514,0.20658682634730538
Zip,33441,Florida,NA,1282,3429,5303,10014,1,176,1526,1703,191733,31673584,765705118,797570435,384194,7.8003120124805e-4,0.05132691746864975,0.28776164435225343,0.17006191332135012,5.871990604815032e-4,0.10334703464474457,0.896065766294774
Zip,33455,Florida,NA,2249,2958,5097,10304,35,19,497,551,67042427,60579256,510114818,637736501,620652,0.015562472209871054,0.006423258958755916,0.09750833823817932,0.053474378881987576,0.06352087114337568,0.034482758620689655,0.9019963702359347
Zip,33458,Florida,NA,7780,5837,5909,19526,495,160,362,1017,112069011,60120324,439136324,611325659,305953,0.06362467866323908,0.027411341442521844,0.061262480961245556,0.05208440028679709,0.48672566371681414,0.15732546705998032,0.3559488692232055
Zip,33460,Florida,NA,2893,3471,3369,9733,293,171,688,1152,30613585,28603674,434568458,493785717,298253,0.10127894918769444,0.049265341400172864,0.20421490056396557,0.11836021781567863,0.2543402777777778,0.1484375,0.5972222222222222
Zip,33462,Florida,NA,3599,3949,3732,11280,517,861,1159,2537,142788941,402718928,1584042199,2129550068,251094,0.14365101417060294,0.21802988098252724,0.31055734190782425,0.2249113475177305,0.20378399684666929,0.33937721718565234,0.45683878596767835
Zip,33469,Florida,NA,2373,2306,3468,8147,209,256,387,852,44925206,106762102,504535063,656222371,385460,0.08807416772018542,0.11101474414570685,0.1115916955017301,0.10457837240702099,0.24530516431924881,0.3004694835680751,0.45422535211267606
Zip,33477,Florida,NA,2108,3962,3954,10024,345,1107,284,1736,84797374,377342660,357341238,819481272,336389.5,0.16366223908918406,0.2794043412417971,0.07182599898836621,0.17318435754189945,0.19873271889400923,0.6376728110599078,0.16359447004608296
Zip,33480,Florida,NA,3531,3535,3574,10640,2050,1945,2123,6118,544330815,1443000447,9885087279,11872418541,515229,0.5805720758991787,0.5502121640735502,0.5940123111359821,0.575,0.3350768224910101,0.3179143510951291,0.3470088264138607
Zip,33483,Florida,NA,215,1768,5952,7935,38,937,3528,4503,16392951,285167622,4202654358,4504214931,554670,0.17674418604651163,0.5299773755656109,0.592741935483871,0.5674858223062382,0.008438818565400843,0.2080834998889629,0.7834776815456362
Zip,33487,Florida,NA,3806,3340,4216,11362,975,1503,933,3411,301879134,738495971,1344796199,2385171304,510968,0.2561744613767735,0.45,0.22129981024667933,0.30021123041718006,0.2858399296394019,0.44063324538258575,0.27352682497801234
Zip,33534,Florida,NA,1314,1293,1292,3899,211,38,125,374,19891311,6487424,42851451,69230186,123594.5,0.16057838660578386,0.029389017788089715,0.09674922600619196,0.09592203129007437,0.5641711229946524,0.10160427807486631,0.3342245989304813
Zip,33570,Florida,NA,2775,2748,2522,8045,623,311,673,1607,67497231,56849447,229613150,353959828,183093,0.22450450450450452,0.11317321688500728,0.2668517049960349,0.1997513983840895,0.38767890479153705,0.19352831362787803,0.4187927815805849
Zip,33572,Florida,NA,2647,2680,2914,8241,768,211,812,1791,85878971,62727270,428474832,577081073,320271,0.29013978088401965,0.07873134328358208,0.2786547700754976,0.21732799417546414,0.4288107202680067,0.11781127861529872,0.4533780011166946
Zip,33602,Florida,NA,189,2513,3031,5733,0,88,192,280,0,20396508,106142599,126539107,338469,0,0.03501790688420215,0.06334543055097328,0.04884004884004884,0,0.3142857142857143,0.6857142857142857
Zip,33604,Florida,NA,6180,5335,862,12377,5,49,82,136,568881,9659905,36338524,46567310,308718,8.090614886731392e-4,0.009184629803186505,0.0951276102088167,0.010988123131615093,0.03676470588235294,0.3602941176470588,0.6029411764705882
Zip,33605,Florida,NA,4896,644,105,5645,267,24,9,300,21792624,4307524,2842172,28942320,77890.5,0.0545343137254902,0.037267080745341616,0.08571428571428572,0.053144375553587246,0.89,0.08,0.03
Zip,33606,Florida,NA,251,831,4192,5274,0,44,1967,2011,0,9835550,1931219941,1941055491,653483,0,0.052948255114320095,0.46922709923664124,0.3813045127038301,0,0.02187966185977126,0.9781203381402287
Zip,33607,Florida,NA,2791,3778,369,6938,210,33,33,276,21440152,5912267,18256858,45609277,103972.5,0.07524184879971337,0.008734780307040762,0.08943089430894309,0.03978091669068896,0.7608695652173914,0.11956521739130435,0.11956521739130435
Zip,33609,Florida,NA,751,2243,4001,6995,78,36,449,563,9310059,6322428,486516866,502149353,523565,0.10386151797603196,0.016049933125278644,0.11222194451387153,0.08048606147248034,0.13854351687388988,0.06394316163410302,0.7975133214920072
Zip,33611,Florida,NA,2181,4835,5154,12170,468,606,846,1920,48390707,124424018,542090186,714904911,245768.5,0.21458046767537828,0.1253360910031024,0.16414435389988358,0.15776499589153656,0.24375,0.315625,0.440625
Zip,33615,Florida,NA,5345,4409,3882,13636,755,592,1111,2458,78853214,107425875,465961471,652240560,199802,0.1412535079513564,0.13427080970741664,0.2861926841834106,0.18025814021707245,0.30716029292107405,0.24084621643612694,0.45199349064279903
Zip,33616,Florida,NA,167,2904,1159,4230,77,587,288,952,9565640,114845333,107473203,231884176,212472,0.46107784431137727,0.20213498622589532,0.24849007765314926,0.22505910165484633,0.08088235294117647,0.6165966386554622,0.3025210084033613
Zip,33619,Florida,NA,5220,2735,2134,10089,67,87,267,421,5562378,10273104,52520518,68356e3,132357,0.012835249042145594,0.03180987202925046,0.12511715089034678,0.04172861532361979,0.15914489311163896,0.20665083135391923,0.6342042755344418
Zip,33629,Florida,NA,90,558,9079,9727,0,65,1678,1743,0,15980460,1467426548,1483407008,620328,0,0.11648745519713262,0.18482211697323495,0.1791919399609335,0,0.037292025243832475,0.9627079747561675
Zip,33634,Florida,NA,1908,2306,1429,5643,96,62,327,485,12745733,10822835,181029929,204598497,499750,0.050314465408805034,0.026886383347788378,0.22883135059482154,0.0859471912103491,0.1979381443298969,0.12783505154639174,0.6742268041237114
Zip,33635,Florida,NA,283,838,2303,3424,26,46,187,259,3064735,8988860,76669119,88722714,331173,0.09187279151943463,0.05489260143198091,0.08119843682153713,0.07564252336448599,0.10038610038610038,0.1776061776061776,0.722007722007722
Zip,33701,Florida,NA,565,649,3503,4717,151,37,139,327,12551556,7737029,123302737,143591322,194313,0.2672566371681416,0.05701078582434515,0.03968027405081359,0.06932372270510918,0.4617737003058104,0.11314984709480122,0.42507645259938837
Zip,33702,Florida,NA,4061,3718,3122,10901,3482,2291,1929,7702,314306548,423294128,764185901,1501786577,157118.5,0.8574242797340557,0.6161915008068855,0.6178731582319026,0.7065406843408861,0.45209036613866527,0.29745520643988577,0.25045442742144897
Zip,33703,Florida,NA,2675,3360,4540,10575,1476,1814,3025,6315,139657410,351980514,1499369422,1991007346,231219,0.5517757009345794,0.5398809523809524,0.6662995594713657,0.5971631205673759,0.233729216152019,0.28725257323832143,0.47901821060965954
Zip,33704,Florida,NA,309,1175,5010,6494,0,96,1805,1901,0,20564688,1651014586,1671579274,621619,0,0.08170212765957446,0.3602794411177645,0.2927317523868186,0,0.05049973698053656,0.9495002630194634
Zip,33705,Florida,NA,4209,3540,2184,9933,1537,912,904,3353,155466014,164942516,461413832,781822362,153898,0.36516987407935375,0.2576271186440678,0.4139194139194139,0.33756166314305847,0.4583954667461974,0.27199522815389204,0.26960930509991055
Zip,33706,Florida,NA,4188,4017,4209,12414,4037,3602,3566,11205,850324856,1356657126,3139695800,5346677782,355907,0.9639446036294174,0.896689071446353,0.847232121644096,0.902609956500725,0.3602855867916109,0.3214636323070058,0.3182507809013833
Zip,33707,Florida,NA,4113,4148,4645,12906,1585,1318,2458,5361,190466785,277908707,1345595608,1813971100,230754,0.38536348164356915,0.31774349083895853,0.5291711517761033,0.4153881915388192,0.2956537959335945,0.24584965491512778,0.45849654915127774
Zip,33708,Florida,NA,3511,4231,3634,11376,2660,2874,2665,8199,623445310,1113262161,2069632086,3806339557,382118,0.7576189119908858,0.6792720397069251,0.7333516785910842,0.7207278481012658,0.32442980851323333,0.3505305525064032,0.3250396389803635
Zip,33709,Florida,NA,5586,3863,1943,11392,254,99,48,401,25345522,17900189,23109744,66355455,127623,0.04547081990691013,0.02562775045301579,0.024704065877509007,0.0352001404494382,0.6334164588528678,0.24688279301745636,0.11970074812967581
Zip,33710,Florida,NA,2889,7110,3873,13872,0,3,169,172,0,659094,153090119,153749213,754114,0,4.219409282700422e-4,0.043635424735347275,0.012399077277970011,0,0.01744186046511628,0.9825581395348837
Zip,33711,Florida,NA,5146,966,1668,7780,523,494,943,1960,59388646,92841495,436232252,588462393,224546,0.10163233579479207,0.5113871635610766,0.565347721822542,0.2519280205655527,0.26683673469387753,0.25204081632653064,0.48112244897959183
Zip,33712,Florida,NA,4138,1781,1749,7668,48,43,95,186,4859358,7900824,46458239,59218421,254126,0.011599806669888834,0.024143739472206625,0.05431675242995998,0.024256651017214397,0.25806451612903225,0.23118279569892472,0.510752688172043
Zip,33715,Florida,NA,826,2415,3558,6799,627,796,1132,2555,182814577,282813548,966577491,1432205616,359708,0.7590799031476998,0.3296066252587992,0.31815626756604837,0.3757905574349169,0.24540117416829746,0.31154598825831703,0.44305283757338554
Zip,33716,Florida,NA,1561,139,643,2343,1528,11,87,1626,121197497,2302012,32273520,155773029,76870,0.9788597053171044,0.07913669064748201,0.13530326594090203,0.6939820742637645,0.939729397293973,0.006765067650676507,0.05350553505535055
Zip,33755,Florida,NA,2205,4738,1619,8562,27,55,132,214,3344414,10622806,87121574,101088794,399623.5,0.012244897959183673,0.011608273533136345,0.08153180975911056,0.024994160242933893,0.1261682242990654,0.2570093457943925,0.616822429906542
Zip,33756,Florida,NA,3528,4988,2892,11408,47,106,302,455,11624030,32733867,342279730,386637627,401442,0.013321995464852607,0.021251002405773857,0.10442600276625173,0.039884291725105186,0.10329670329670329,0.23296703296703297,0.6637362637362637
Zip,33759,Florida,NA,1866,1597,1656,5119,199,11,20,230,12030181,1938474,11094152,25062807,60454.5,0.10664523043944266,0.0068879148403256105,0.012077294685990338,0.044930650517679235,0.8652173913043478,0.04782608695652174,0.08695652173913043
Zip,33760,Florida,NA,1975,1398,1103,4476,242,145,53,440,25715160,22174720,27287423,75177303,131219,0.12253164556962025,0.10371959942775394,0.04805077062556664,0.09830205540661305,0.55,0.32954545454545453,0.12045454545454545
Zip,33762,Florida,NA,747,1059,815,2621,565,422,356,1343,65997404,85543439,206202907,357743750,158564,0.7563587684069611,0.39848914069877245,0.4368098159509202,0.5123998473864937,0.4206999255398362,0.31422189128816086,0.265078183172003
Zip,33764,Florida,NA,3515,2695,3831,10041,282,432,506,1220,31281442,77508080,205356464,314145986,198570.5,0.0802275960170697,0.16029684601113173,0.1320803967632472,0.12150184244597152,0.23114754098360657,0.3540983606557377,0.41475409836065574
Zip,33767,Florida,NA,154,848,7652,8654,142,615,4734,5491,12035848,127863047,3271823392,3411722287,467575,0.922077922077922,0.7252358490566038,0.6186617877679038,0.634504275479547,0.025860498998360956,0.11200145692952103,0.862138044072118
Zip,33770,Florida,NA,2466,3212,3039,8717,52,114,332,498,10718314,37200967,276519239,324438520,532445.5,0.021086780210867802,0.03549190535491906,0.10924646265218822,0.05712974647241023,0.10441767068273092,0.2289156626506024,0.6666666666666666
Zip,33771,Florida,NA,2338,4047,1785,8170,61,14,34,109,4828230,2288804,10418285,17535319,88838,0.026090675791274595,0.003459352606869286,0.01904761904761905,0.013341493268053856,0.5596330275229358,0.12844036697247707,0.3119266055045872
Zip,33772,Florida,NA,3411,3748,2403,9562,20,13,208,241,2017942,3161119,109014954,114194015,487882,0.005863383172090296,0.0034685165421558164,0.08655846858094049,0.02520393223175068,0.08298755186721991,0.05394190871369295,0.8630705394190872
Zip,33774,Florida,NA,2586,2491,3281,8358,48,18,135,201,4825246,2751412,111044233,118620891,378401,0.018561484918793503,0.0072260136491368926,0.04114599207558671,0.02404881550610194,0.23880597014925373,0.08955223880597014,0.6716417910447762
Zip,33776,Florida,NA,484,1639,3180,5303,31,59,162,252,4717096,14225595,97702643,116645334,353520.5,0.0640495867768595,0.03599755948749237,0.0509433962264151,0.047520271544408826,0.12301587301587301,0.23412698412698413,0.6428571428571429
Zip,33777,Florida,NA,3575,2062,1908,7545,154,95,365,614,19198154,20660291,164757510,204615955,309685,0.043076923076923075,0.0460717749757517,0.19129979035639413,0.08137839628893306,0.250814332247557,0.15472312703583063,0.5944625407166124
Zip,33785,Florida,NA,1825,1853,1827,5505,1544,1354,1070,3968,456209439,587937262,852635600,1896782301,396165,0.846027397260274,0.730706961683756,0.5856595511767926,0.7207992733878292,0.38911290322580644,0.34122983870967744,0.2696572580645161
Zip,33786,Florida,NA,419,427,429,1275,289,268,335,892,128717023,174282531,452943708,755943262,567231,0.6897374701670644,0.6276346604215457,0.7808857808857809,0.6996078431372549,0.3239910313901345,0.3004484304932735,0.3755605381165919
Zip,33901,Florida,NA,3075,1494,1554,6123,80,51,528,659,6683408,10658537,423961746,441303691,499577,0.026016260162601626,0.03413654618473896,0.33976833976833976,0.1076269802384452,0.12139605462822459,0.07738998482549317,0.8012139605462822
Zip,33903,Florida,NA,2731,3372,2697,8800,288,833,1317,2438,20816251,124814770,487211753,632842774,212704.5,0.10545587696814354,0.2470344009489917,0.4883203559510567,0.27704545454545454,0.11812961443806398,0.3416735028712059,0.5401968826907301
Zip,33904,Florida,NA,6314,4503,6700,17517,1957,955,2227,5139,284165756,212403513,1089270909,1585840178,226863,0.30994615140956605,0.21208083499888963,0.33238805970149254,0.2933721527658846,0.38081338781864177,0.18583381980930141,0.4333527923720568
Zip,33905,Florida,NA,6324,2525,2647,11496,604,238,681,1523,57201543,49688565,286688622,393578730,230834,0.09550917141049968,0.09425742574257426,0.2572723838307518,0.13248086290883784,0.39658568614576495,0.15627051871306633,0.44714379514116875
Zip,33908,Florida,NA,6674,6985,10089,23748,3692,1712,2783,8187,386765424,357597121,1560287706,2304650251,183666,0.5531914893617021,0.24509663564781675,0.27584497968084054,0.344744820616473,0.4509588371808965,0.20911200684011239,0.3399291559789911
Zip,33914,Florida,NA,3738,6006,9150,18894,522,337,1404,2263,77953049,79058134,758530573,915541756,375666,0.13964686998394862,0.05611055611055611,0.15344262295081967,0.11977347306023076,0.23066725585505965,0.14891736632788333,0.620415377817057
Zip,33916,Florida,NA,4607,1176,831,6614,121,185,347,653,11202131,42855103,118628348,172685582,281150,0.02626438029086173,0.15731292517006804,0.4175691937424789,0.09872996673722408,0.18529862174578868,0.2833078101071976,0.5313935681470138
Zip,33917,Florida,NA,4566,3443,4481,12490,376,669,608,1653,30185212,86391034,200927256,317503502,137683,0.08234778799824792,0.19430729015393552,0.1356839991073421,0.13234587670136108,0.22746521476104054,0.4047186932849365,0.367816091954023
Zip,33919,Florida,NA,6225,6178,4933,17336,1691,1554,862,4107,190648488,319422483,467110527,977181498,181430,0.2716465863453815,0.2515377144707025,0.17474153659031016,0.23690586063682512,0.41173606038470906,0.3783783783783784,0.2098855612369126
Zip,33920,Florida,NA,566,829,791,2186,6,38,98,142,845047,9025968,59916182,69787197,368400.5,0.01060070671378092,0.045838359469240045,0.12389380530973451,0.06495882891125343,0.04225352112676056,0.2676056338028169,0.6901408450704225
Zip,33921,Florida,NA,559,565,637,1761,258,476,460,1194,230585513,681198533,1418069696,2329853742,1493149,0.46153846153846156,0.8424778761061947,0.7221350078492935,0.6780238500851788,0.21608040201005024,0.39865996649916247,0.3852596314907873
Zip,33922,Florida,NA,830,819,668,2317,462,546,462,1470,60754392,134229845,228833079,423817316,239901,0.5566265060240964,0.6666666666666666,0.6916167664670658,0.6344410876132931,0.3142857142857143,0.37142857142857144,0.3142857142857143
Zip,33924,Florida,NA,322,327,835,1484,322,289,673,1284,149894283,287583707,1027554802,1465032792,703136,1,0.8837920489296636,0.8059880239520958,0.8652291105121294,0.2507788161993769,0.2250778816199377,0.5241433021806854
Zip,33931,Florida,NA,3487,3500,3520,10507,3242,2949,2859,9050,841799114,1196019002,2163661055,4201479171,385242.5,0.929739030685403,0.8425714285714285,0.8122159090909091,0.8613305415437328,0.35823204419889504,0.3258563535911602,0.31591160220994474
Zip,33946,Florida,NA,436,756,1310,2502,239,485,1043,1767,58553178,181546076,816931956,1057031210,470884,0.5481651376146789,0.6415343915343915,0.7961832061068702,0.7062350119904077,0.1352574985851726,0.2744765138653084,0.590265987549519
Zip,33947,Florida,NA,1922,1882,1871,5675,191,143,61,395,35188525,46182965,24424491,105795981,274876,0.09937565036420395,0.07598299681190224,0.03260288615713522,0.06960352422907488,0.4835443037974684,0.3620253164556962,0.15443037974683543
Zip,33948,Florida,NA,2318,3698,2394,8410,238,463,533,1234,30521801,83101441,187917327,301540569,200769.5,0.10267471958584987,0.12520281233098973,0.22263993316624894,0.14673008323424494,0.19286871961102106,0.3752025931928687,0.4319286871961102
Zip,33950,Florida,NA,3163,3220,6553,12936,2090,1987,2212,6289,262422267,452756093,1057500099,1772678459,230382,0.6607650964274423,0.617080745341615,0.3375553181748817,0.4861626468769326,0.3323262839879154,0.3159484814755923,0.3517252345364923
Zip,33952,Florida,NA,7860,4635,2917,15412,544,437,614,1595,64244924,74805628,290870370,429920922,171983,0.06921119592875317,0.09428263214670982,0.21049022968803566,0.10349078640020763,0.34106583072100316,0.27398119122257053,0.3849529780564263
Zip,33953,Florida,NA,599,811,2230,3640,400,104,331,835,38474365,19039002,143949877,201463244,159601,0.667779632721202,0.1282367447595561,0.1484304932735426,0.22939560439560439,0.47904191616766467,0.12455089820359282,0.3964071856287425
Zip,33955,Florida,NA,1663,1802,2191,5656,67,84,236,387,10666634,19613783,116629366,146909783,331904,0.04028863499699339,0.04661487236403995,0.10771337288909173,0.06842291371994343,0.1731266149870801,0.21705426356589147,0.6098191214470284
Zip,33956,Florida,NA,1014,1017,1031,3062,793,787,767,2347,113248181,186818309,376235431,676301921,223096,0.782051282051282,0.7738446411012783,0.7439379243452958,0.7664924885695624,0.33787814230933105,0.33532168726033235,0.3268001704303366
Zip,33957,Florida,NA,2395,2397,2403,7195,1856,2043,2176,6075,918666788,1508288984,3207634656,5634590428,759479,0.7749478079331942,0.8523153942428036,0.9055347482313775,0.8443363446838082,0.30551440329218105,0.3362962962962963,0.35818930041152264
Zip,33980,Florida,NA,2679,1571,792,5042,415,104,83,602,55316017,25044129,52557892,132918038,159019,0.15490854796565884,0.06619987269255251,0.10479797979797979,0.11939706465688218,0.6893687707641196,0.17275747508305647,0.1378737541528239
Zip,33981,Florida,NA,1329,1547,3349,6225,19,65,585,669,2167418,12254624,231468757,245890799,337450,0.014296463506395787,0.04201680672268908,0.17467900865930128,0.10746987951807228,0.028400597907324365,0.09715994020926756,0.874439461883408
Zip,33982,Florida,NA,1708,806,900,3414,339,35,94,468,33147818,8459040,64281631,105888489,115816,0.19847775175644028,0.043424317617866005,0.10444444444444445,0.13708260105448156,0.7243589743589743,0.07478632478632478,0.20085470085470086
Zip,33983,Florida,NA,2068,4169,1005,7242,38,48,77,163,5163221,11422719,33957657,50543597,275435,0.0183752417794971,0.011513552410650036,0.07661691542288557,0.022507594587130628,0.2331288343558282,0.294478527607362,0.4723926380368098
Zip,33990,Florida,NA,4086,4197,3254,11537,455,283,92,830,58030038,59842104,38843833,156715975,181214.5,0.1113558492413118,0.06742911603526329,0.028272894898586354,0.07194244604316546,0.5481927710843374,0.3409638554216867,0.1108433734939759
Zip,33991,Florida,NA,2074,3977,2737,8788,30,127,307,464,4164346,31457663,129764139,165386148,334096.5,0.01446480231436837,0.03193361830525522,0.11216660577274389,0.05279927173418298,0.06465517241379311,0.27370689655172414,0.6616379310344828
Zip,33993,Florida,NA,3528,3832,2519,9879,33,97,624,754,5222923,24229929,294602673,324055525,402808.5,0.00935374149659864,0.025313152400835072,0.24771734815402938,0.07632351452576172,0.04376657824933687,0.1286472148541114,0.8275862068965517
Zip,34102,Florida,NA,370,2355,5689,8414,215,1483,2396,4094,43732379,555003411,5513549219,6112285009,586996.5,0.581081081081081,0.629723991507431,0.4211636491474776,0.4865700023769907,0.052515876893014166,0.36223742061553493,0.5852467024914509
Zip,34103,Florida,NA,1198,2300,6316,9814,0,294,2284,2578,0,129878840,3855389642,3985268482,1052141.5,0,0.12782608695652173,0.3616212792906903,0.26268595883431833,0,0.11404189294026378,0.8859581070597362
Zip,34104,Florida,NA,7272,3637,1452,12361,509,304,143,956,97840903,103383438,103491726,304716067,245345,0.069994499449945,0.08358537255980203,0.09848484848484848,0.07734002103389694,0.5324267782426778,0.3179916317991632,0.14958158995815898
Zip,34105,Florida,NA,4186,3002,2615,9803,115,246,34,395,15191517,87957895,125369109,228518521,309848,0.027472527472527472,0.08194536975349767,0.0130019120458891,0.04029378761603591,0.2911392405063291,0.6227848101265823,0.08607594936708861
Zip,34108,Florida,NA,412,4491,8672,13575,108,338,2682,3128,17550386,141161328,4385340865,4544052579,1110781.5,0.2621359223300971,0.07526163437987085,0.30927121771217714,0.23042357274401473,0.034526854219948847,0.10805626598465473,0.8574168797953964
Zip,34110,Florida,NA,3228,5303,4996,13527,46,123,656,825,10348911,46209319,609374909,665933139,741015,0.014250309789343246,0.023194418253818593,0.1313050440352282,0.06098913284542027,0.055757575757575756,0.14909090909090908,0.7951515151515152
Zip,34112,Florida,NA,11004,3661,1429,16094,4671,627,182,5480,692744145,215111772,137023609,1044879526,155924.5,0.4244820065430752,0.17126468178093418,0.12736179146256124,0.3404995650553001,0.8523722627737226,0.11441605839416058,0.03321167883211679
Zip,34113,Florida,NA,4606,3782,3044,11432,2080,1236,964,4280,365707652,412645947,809584986,1587938585,260163,0.4515848892748589,0.3268112109994712,0.316688567674113,0.37438768369489156,0.48598130841121495,0.288785046728972,0.2252336448598131
Zip,34114,Florida,NA,5734,4514,1515,11763,4475,1920,764,7159,657347223,737240593,598102327,1992690143,203730,0.7804325078479246,0.4253433761630483,0.5042904290429043,0.6086032474708832,0.6250873026959073,0.2681938818270708,0.10671881547702193
Zip,34134,Florida,NA,2434,3886,6904,13224,483,521,2548,3552,101512268,186153903,3348120420,3635786591,637988,0.19843878389482333,0.13407102418939784,0.3690614136732329,0.26860254083484575,0.13597972972972974,0.14667792792792791,0.7173423423423423
Zip,34135,Florida,NA,9630,8379,4694,22703,130,240,170,540,24738907,85068345,115290544,225097796,368960.5,0.013499480789200415,0.028643036161833155,0.03621644652748189,0.023785402810201296,0.24074074074074073,0.4444444444444444,0.3148148148148148
Zip,34138,Florida,NA,75,74,75,224,36,52,60,148,4897753,11681402,27280430,43859585,248285,0.48,0.7027027027027027,0.8,0.6607142857142857,0.24324324324324326,0.35135135135135137,0.40540540540540543
Zip,34139,Florida,NA,131,139,106,376,131,138,105,374,19909823,36039812,47405800,103355435,241256.5,1,0.9928057553956835,0.9905660377358491,0.9946808510638298,0.3502673796791444,0.3689839572192513,0.2807486631016043
Zip,34140,Florida,NA,112,107,57,276,111,96,51,258,27254681,36697398,29390982,93343061,340125.5,0.9910714285714286,0.897196261682243,0.8947368421052632,0.9347826086956522,0.43023255813953487,0.37209302325581395,0.19767441860465115
Zip,34145,Florida,NA,5854,5807,5878,17539,2909,1927,2539,7375,864787767,1189278021,3893304934,5947370722,562341,0.49692517936453706,0.33184088169450665,0.43194964273562436,0.4204914761388905,0.3944406779661017,0.26128813559322034,0.34427118644067795
Zip,34205,Florida,NA,5706,4623,582,10911,70,62,132,264,4412362,13738862,74262542,92413766,287463,0.012267788293024886,0.013411204845338524,0.2268041237113402,0.024195765740995325,0.26515151515151514,0.23484848484848486,0.5
Zip,34207,Florida,NA,8844,3230,301,12375,183,87,46,316,16156185,14923732,38594094,69674011,138050,0.020691994572591587,0.02693498452012384,0.15282392026578073,0.025535353535353536,0.5791139240506329,0.27531645569620256,0.14556962025316456
Zip,34208,Florida,NA,5093,2753,2362,10208,787,526,609,1922,62257160,111118711,323796308,497172179,182894,0.1545258197526016,0.1910642934980022,0.2578323454699407,0.18828369905956113,0.4094693028095734,0.2736732570239334,0.31685744016649325
Zip,34209,Florida,NA,2904,7614,4506,15024,12,251,668,931,2125217,58058538,462744191,522927946,465694,0.004132231404958678,0.03296558970317835,0.14824678206835332,0.06196751863684771,0.01288936627282492,0.2696025778732546,0.7175080558539205
Zip,34210,Florida,NA,3450,3293,1979,8722,807,731,689,2227,90217376,147105086,376113751,613436213,192028,0.23391304347826086,0.22198603097479502,0.348155634158666,0.2553313460215547,0.36237090255949705,0.3282442748091603,0.3093848226313426
Zip,34212,Florida,NA,376,1895,5288,7559,1,69,121,191,140857,14656575,70644226,85441658,377127,0.0026595744680851063,0.03641160949868074,0.022881996974281393,0.025267892578383383,0.005235602094240838,0.3612565445026178,0.6335078534031413
Zip,34215,Florida,NA,44,165,207,416,44,165,175,384,9964750,68235334,148353513,226553597,513693,1,1,0.8454106280193237,0.9230769230769231,0.11458333333333333,0.4296875,0.4557291666666667
Zip,34216,Florida,NA,457,457,459,1373,457,457,453,1367,326430187,421099715,697105485,1444635387,923294,1,1,0.9869281045751634,0.9956300072833212,0.33430870519385514,0.33430870519385514,0.33138258961228967
Zip,34217,Florida,NA,1800,1773,1779,5352,1571,1720,1676,4967,532910578,952787240,1705105236,3190803054,560673,0.8727777777777778,0.970107163000564,0.9421023046655425,0.9280642750373692,0.31628749748339036,0.34628548419569155,0.33742701832091804
Zip,34221,Florida,NA,5115,5067,4944,15126,1165,822,1177,3164,92903891,143633511,566838191,803375593,171953.5,0.22776148582600195,0.16222616933096506,0.2380663430420712,0.2091762528097316,0.36820480404551204,0.25979772439949433,0.3719974715549937
Zip,34222,Florida,NA,1317,1273,1312,3902,14,201,291,506,1266844,36691784,123330825,161289453,265152,0.010630220197418374,0.15789473684210525,0.22179878048780488,0.12967708867247565,0.02766798418972332,0.39723320158102765,0.575098814229249
Zip,34223,Florida,NA,3096,3937,4901,11934,141,509,1483,2133,18198175,115363611,926564772,1060126558,342432,0.045542635658914726,0.12928625857251713,0.3025913078963477,0.17873303167420815,0.06610407876230662,0.23863103609939054,0.6952648851383029
Zip,34224,Florida,NA,4510,3388,1922,9820,438,72,502,1012,51918190,16345436,258194890,326458516,269851,0.09711751662971176,0.021251475796930343,0.2611862643080125,0.10305498981670061,0.43280632411067194,0.07114624505928854,0.49604743083003955
Zip,34228,Florida,NA,2857,2852,2861,8570,1841,1693,1384,4918,651447622,1137474461,2337813794,4126735877,614570,0.6443822191109555,0.5936185133239832,0.4837469416288011,0.5738623103850642,0.3743391622610817,0.3442456283041887,0.2814152094347296
Zip,34229,Florida,NA,1284,1295,1288,3867,103,37,113,253,25139447,17946595,277380651,320466693,500514,0.08021806853582554,0.02857142857142857,0.08773291925465838,0.06542539436255496,0.40711462450592883,0.14624505928853754,0.44664031620553357
Zip,34231,Florida,NA,5402,5786,3788,14976,78,358,644,1080,14632704,95398408,697454474,807485586,369481,0.014439096630877453,0.06187348772900104,0.1700105596620908,0.07211538461538461,0.07222222222222222,0.3314814814814815,0.5962962962962963
Zip,34236,Florida,NA,200,1165,6061,7426,2,434,2431,2867,267063,125799800,2846530112,2972596975,637562,0.01,0.3725321888412017,0.4010889292196007,0.3860759493670886,6.975933031042902e-4,0.15137774677363097,0.8479246599232647
Zip,34239,Florida,NA,1390,3415,1884,6689,45,5,176,226,6661668,1100563,514246909,522009140,1975005,0.03237410071942446,0.0014641288433382138,0.09341825902335456,0.03378681417252205,0.19911504424778761,0.022123893805309734,0.7787610619469026
Zip,34242,Florida,NA,2531,2578,4793,9902,2051,1856,4154,8061,760649324,1103582030,4649930643,6514161997,570266,0.8103516396681154,0.7199379363847944,0.8666805758397663,0.8140779640476672,0.2544349336310631,0.2302443865525369,0.5153206798164
Zip,34243,Florida,NA,2709,5913,3779,12401,186,24,53,263,17570515,6409701,49354360,73334576,94113,0.06866002214839424,0.004058853373921867,0.014024874305371792,0.021207967099427464,0.7072243346007605,0.09125475285171103,0.20152091254752852
Zip,34250,Florida,NA,81,78,93,252,75,62,71,208,16714479,26841155,59092934,102648568,428530.5,0.9259259259259259,0.7948717948717948,0.7634408602150538,0.8253968253968254,0.3605769230769231,0.2980769230769231,0.34134615384615385
Zip,34275,Florida,NA,3040,3022,3037,9099,536,314,580,1430,74504261,93812048,630840669,799156978,305956.5,0.1763157894736842,0.10390469887491727,0.19097793875535068,0.157160127486537,0.3748251748251748,0.21958041958041957,0.40559440559440557
Zip,34285,Florida,NA,5035,2385,4526,11946,259,183,532,974,30054339,48053741,346774039,424882119,329810,0.05143992055610725,0.07672955974842767,0.1175430844012373,0.08153356772141303,0.26591375770020537,0.18788501026694046,0.5462012320328542
Zip,34287,Florida,NA,8460,2131,2896,13487,1769,172,48,1989,207733346,30343675,13259431,251336452,126555,0.2091016548463357,0.08071328015016424,0.016574585635359115,0.14747534663008824,0.8893916540975364,0.08647561588738059,0.024132730015082957
Zip,34293,Florida,NA,7173,8245,4829,20247,72,81,148,301,11137735,20229982,109211003,140578720,312921,0.010037641154328732,0.009824135839902971,0.030648167322427002,0.014866399960487973,0.23920265780730898,0.2691029900332226,0.49169435215946844
Zip,34428,Florida,NA,1763,1049,1374,4186,368,256,575,1199,26652892,33816829,197341966,257811687,166094,0.20873511060692002,0.2440419447092469,0.41848617176128095,0.28643096034400384,0.30692243536280234,0.213511259382819,0.47956630525437866
Zip,34429,Florida,NA,1253,1961,1483,4697,477,682,1097,2256,35548679,95426938,393314597,524290214,172563,0.38068635275339185,0.3477817440081591,0.7397167902899529,0.4803065786672344,0.21143617021276595,0.30230496453900707,0.4862588652482269
Zip,34448,Florida,NA,2383,1613,1511,5507,599,544,1266,2409,34684764,68850488,427701355,531236607,178914,0.25136382710868654,0.33725976441413513,0.8378557246856386,0.4374432540403123,0.24865089248650893,0.22581984225819843,0.5255292652552926
Zip,34449,Florida,NA,588,568,551,1707,51,53,85,189,3527712,4620906,21048417,29197035,96126,0.08673469387755102,0.09330985915492958,0.1542649727767695,0.11072056239015818,0.2698412698412698,0.2804232804232804,0.4497354497354497
Zip,34498,Florida,NA,144,144,151,439,106,97,94,297,8967001,13663826,26173738,48804565,137614,0.7361111111111112,0.6736111111111112,0.6225165562913907,0.6765375854214123,0.3569023569023569,0.3265993265993266,0.3164983164983165
Zip,34607,Florida,NA,1009,1175,1849,4033,703,748,737,2188,111657288,170874507,273116325,555648120,235471,0.6967294350842418,0.6365957446808511,0.3985938345051379,0.5425241755516985,0.3212979890310786,0.34186471663619744,0.33683729433272397
Zip,34652,Florida,NA,6644,2855,2698,12197,1552,1040,1755,4347,81297484,159999234,615206113,856502831,168298,0.23359422034918723,0.36427320490367776,0.6504818383988139,0.3563991145363614,0.35702783528870485,0.23924545663676097,0.40372670807453415
Zip,34653,Florida,NA,4777,5638,929,11344,128,71,40,239,7342713,10936777,14205572,32485062,91058,0.026795059660875028,0.012593118126995389,0.04305705059203445,0.021068406205923835,0.5355648535564853,0.29707112970711297,0.16736401673640167
Zip,34667,Florida,NA,5277,5328,5208,15813,768,1166,1664,3598,52680459,155610790,411609345,619900594,159700.5,0.14553723706651506,0.21884384384384384,0.3195084485407066,0.22753430721558213,0.21345191773207337,0.32406892718176766,0.462479155086159
Zip,34668,Florida,NA,6322,6346,6236,18904,676,127,944,1747,28667549,11743462,248652851,289063862,122056,0.10692818728250554,0.02001260636621494,0.15137908915971776,0.09241430385103681,0.386949055523755,0.0726960503720664,0.5403548941041786
Zip,34677,Florida,NA,3036,2989,3110,9135,64,350,391,805,9820921,77717085,192720203,280258209,286047,0.021080368906455864,0.117096018735363,0.1257234726688103,0.08812260536398467,0.07950310559006211,0.43478260869565216,0.4857142857142857
Zip,34681,Florida,NA,68,199,345,612,42,101,228,371,7233134,23790452,170185389,201208975,359810,0.6176470588235294,0.507537688442211,0.6608695652173913,0.6062091503267973,0.11320754716981132,0.2722371967654987,0.6145552560646901
Zip,34683,Florida,NA,3648,4788,5238,13674,321,325,728,1374,38223069,78669831,466615155,583508055,309369.5,0.08799342105263158,0.06787802840434419,0.13898434516991218,0.10048266783677051,0.2336244541484716,0.23653566229985443,0.529839883551674
Zip,34684,Florida,NA,5733,4777,1839,12349,149,268,203,620,20609824,60491584,93098244,174199652,239798,0.025989883132740275,0.05610215616495708,0.11038607939097335,0.05020649445299215,0.2403225806451613,0.432258064516129,0.32741935483870965
Zip,34685,Florida,NA,1763,1638,3765,7166,43,80,97,220,4289703,18111120,70398757,92799580,265059,0.024390243902439025,0.04884004884004884,0.025763612217795485,0.030700530281886688,0.19545454545454546,0.36363636363636365,0.4409090909090909
Zip,34688,Florida,NA,913,329,2409,3651,3,40,90,133,489540,8008012,72083101,80580653,492710,0.0032858707557502738,0.12158054711246201,0.037359900373599,0.03642837578745549,0.022556390977443608,0.3007518796992481,0.6766917293233082
Zip,34689,Florida,NA,3906,4590,2726,11222,517,878,999,2394,68189139,199205691,529666873,797061703,254044,0.13236047107014848,0.19128540305010894,0.3664710198092443,0.21333095704865443,0.2159565580618212,0.366750208855472,0.41729323308270677
Zip,34690,Florida,NA,2226,2247,1844,6317,4,31,196,231,219588,2786283,43974639,46980510,199039,0.0017969451931716084,0.013796172674677348,0.10629067245119306,0.03656799113503245,0.017316017316017316,0.1341991341991342,0.8484848484848485
Zip,34691,Florida,NA,3559,3550,3838,10947,69,102,237,408,4635184,10371929,79925244,94932357,128575,0.01938746838999719,0.02873239436619718,0.06175091193329859,0.037270485064401206,0.16911764705882354,0.25,0.5808823529411765
Zip,34695,Florida,NA,2413,2424,2438,7275,22,15,78,115,3003072,3822738,61580288,68406098,385713,0.009117281392457521,0.006188118811881188,0.03199343724364233,0.015807560137457044,0.19130434782608696,0.13043478260869565,0.6782608695652174
Zip,34698,Florida,NA,5773,5673,5646,17092,623,912,993,2528,69158931,180735334,515849e3,765743265,211726.5,0.10791616144119176,0.16076150185087257,0.1758767268862912,0.14790545284343554,0.24643987341772153,0.36075949367088606,0.3928006329113924
Zip,34946,Florida,NA,978,601,303,1882,22,65,85,172,3436823,19193052,56524748,79154623,387599,0.022494887525562373,0.10815307820299501,0.28052805280528054,0.09139213602550478,0.12790697674418605,0.37790697674418605,0.4941860465116279
Zip,34949,Florida,NA,86,1893,4945,6924,67,1354,2603,4024,7459627,223956039,977062421,1208478087,236598,0.7790697674418605,0.7152667723190702,0.5263902932254803,0.5811669555170422,0.01665009940357853,0.3364811133200795,0.6468687872763419
Zip,34952,Florida,NA,9467,3232,3349,16048,165,41,32,238,23558449,8114361,13545600,45218410,154739.5,0.017428963768881377,0.012685643564356437,0.00955509107196178,0.014830508474576272,0.6932773109243697,0.1722689075630252,0.13445378151260504
Zip,34957,Florida,NA,5075,4274,4462,13811,2682,1145,664,4491,418977163,321695846,377708913,1118381922,213171,0.5284729064039408,0.2678989237248479,0.14881219184222322,0.32517558467887914,0.5971943887775552,0.25495435315074594,0.14785125807169897
Zip,34990,Florida,NA,4130,4131,4140,12401,221,151,459,831,45525406,54998563,316921915,417445884,500884,0.05351089588377724,0.03655289276204309,0.1108695652173913,0.06701072494153697,0.26594464500601683,0.18170878459687123,0.5523465703971119
Zip,34994,Florida,NA,3956,2234,1298,7488,408,426,276,1110,40438706,84948192,193508462,318895360,170607,0.10313447927199192,0.19068934646374217,0.21263482280431434,0.1482371794871795,0.3675675675675676,0.3837837837837838,0.24864864864864866
Zip,34996,Florida,NA,2756,2219,2408,7383,170,879,538,1587,51961983,291230584,507993683,851186250,326066,0.061683599419448475,0.3961243803515097,0.223421926910299,0.21495327102803738,0.10712035286704474,0.553875236294896,0.3390044108380592
Zip,34997,Florida,NA,4579,6267,7417,18263,379,352,494,1225,47161607,77779241,248837152,373778e3,240477,0.0827691635728325,0.05616722514759853,0.06660374814615073,0.06707550785741663,0.3093877551020408,0.2873469387755102,0.403265306122449
Zip,36509,Alabama,NA,298,274,290,862,110,104,106,320,4408640,5689511,12022043,22120194,53905.5,0.3691275167785235,0.3795620437956204,0.36551724137931035,0.37122969837587005,0.34375,0.325,0.33125
Zip,36523,Alabama,NA,530,535,535,1600,265,287,167,719,13045326,20361548,37837107,71243981,64151,0.5,0.5364485981308411,0.3121495327102804,0.449375,0.36856745479833103,0.3991655076495132,0.23226703755215578
Zip,36528,Alabama,NA,588,591,609,1788,474,492,538,1504,78953605,130991001,221207221,431151827,269757.5,0.8061224489795918,0.8324873096446701,0.8834154351395731,0.8411633109619687,0.3151595744680851,0.3271276595744681,0.35771276595744683
Zip,36530,Alabama,NA,927,921,1108,2956,43,45,393,481,3961568,9839012,224891496,238692076,452292,0.04638619201725998,0.048859934853420196,0.3546931407942238,0.16271989174560217,0.0893970893970894,0.09355509355509356,0.817047817047817
Zip,36532,Alabama,NA,3892,3741,3514,11147,48,99,255,402,7969835,29350862,148130798,185451495,388576.5,0.012332990750256937,0.026463512429831595,0.07256687535571998,0.03606351484704405,0.11940298507462686,0.2462686567164179,0.6343283582089553
Zip,36535,Alabama,NA,2832,2896,2572,8300,20,22,97,139,2272747,3458251,39585625,45316623,287245,0.007062146892655367,0.007596685082872928,0.03771384136858476,0.016746987951807228,0.14388489208633093,0.15827338129496402,0.697841726618705
Zip,36542,Alabama,NA,3163,3252,3342,9757,604,899,1402,2905,89910732,226495473,806463713,1122869918,312015,0.19095795131204552,0.2764452644526445,0.419509275882705,0.29773495951624473,0.20791738382099828,0.30946643717728056,0.48261617900172116
Zip,36555,Alabama,NA,169,139,332,640,8,15,113,136,1120114,2359235,46013783,49493132,371739,0.047337278106508875,0.1079136690647482,0.34036144578313254,0.2125,0.058823529411764705,0.11029411764705882,0.8308823529411765
Zip,36561,Alabama,NA,2820,2831,2717,8368,545,426,769,1740,119015503,153973225,613836481,886825209,396001.5,0.19326241134751773,0.15047686329918758,0.28303275671696726,0.20793499043977057,0.3132183908045977,0.24482758620689654,0.4419540229885057
Zip,36571,Alabama,NA,1953,1957,1952,5862,82,21,19,122,5220471,2649357,4321635,12191463,72982.5,0.04198668714797747,0.010730710270822688,0.00973360655737705,0.020812009553053564,0.6721311475409836,0.1721311475409836,0.1557377049180328
Zip,36582,Alabama,NA,2861,2935,3075,8871,84,46,258,388,5550103,4908656,106828445,117287204,195002,0.029360363509262497,0.015672913117546847,0.08390243902439025,0.043738022770826286,0.21649484536082475,0.11855670103092783,0.6649484536082474
Zip,36603,Alabama,NA,2680,484,186,3350,139,0,0,139,5810849,0,0,5810849,41756,0.051865671641791046,0,0,0.04149253731343284,1,0,0
Zip,36605,Alabama,NA,7922,1915,903,10740,324,168,223,715,16978861,18961440,67040388,102980689,84572,0.040898762938651856,0.08772845953002611,0.2469545957918051,0.06657355679702048,0.45314685314685316,0.23496503496503496,0.3118881118881119
Zip,36611,Alabama,NA,904,875,885,2664,12,3,103,118,1017160,195730,14124101,15336991,124457,0.01327433628318584,0.0034285714285714284,0.11638418079096045,0.044294294294294295,0.1016949152542373,0.025423728813559324,0.8728813559322034
Zip,36619,Alabama,NA,778,2651,2038,5467,3,34,177,214,218745,4053417,52080747,56352909,193483.5,0.0038560411311053984,0.012825348924933987,0.08684985279685967,0.039143954636912386,0.014018691588785047,0.1588785046728972,0.8271028037383178
Zip,39507,Mississippi,NA,1237,2011,2290,5538,1,10,122,133,69634,998805,33906235,34974674,250467,8.084074373484236e-4,0.004972650422675286,0.05327510917030567,0.02401589021307331,0.007518796992481203,0.07518796992481203,0.9172932330827067
Zip,39520,Mississippi,NA,1669,1670,1681,5020,515,563,360,1438,38572246,69040022,86840178,194452446,109336,0.3085680047932894,0.33712574850299404,0.21415823914336704,0.2864541832669323,0.3581363004172462,0.39151599443671764,0.25034770514603616
Zip,39530,Mississippi,NA,2869,1162,394,4425,94,18,23,135,6876962,1858214,5608079,14343255,74314,0.03276402927849425,0.01549053356282272,0.0583756345177665,0.030508474576271188,0.6962962962962963,0.13333333333333333,0.17037037037037037
Zip,39532,Mississippi,NA,1543,3299,3642,8484,18,89,131,238,1387116,10249047,34078283,45714446,159729,0.011665586519766688,0.026977872082449228,0.03596924766611752,0.028052805280528052,0.07563025210084033,0.3739495798319328,0.5504201680672269
Zip,39553,Mississippi,NA,2231,2198,2027,6456,22,86,313,421,1383441,8806834,62949660,73139935,154042,0.009861048857014791,0.039126478616924476,0.1544153922052294,0.06521065675340769,0.052256532066508314,0.2042755344418052,0.7434679334916865
Zip,39556,Mississippi,NA,650,644,654,1948,6,53,104,163,502943,6678273,25439599,32620815,177128,0.009230769230769232,0.08229813664596274,0.15902140672782875,0.08367556468172485,0.03680981595092025,0.32515337423312884,0.6380368098159509
Zip,39562,Mississippi,NA,598,1776,2885,5259,86,130,68,284,4402714,10404139,10144950,24951803,74806,0.14381270903010032,0.0731981981981982,0.023570190641247834,0.05400266210306142,0.3028169014084507,0.45774647887323944,0.23943661971830985
Zip,39563,Mississippi,NA,3082,1918,792,5792,270,146,118,534,12432026,11727435,22630140,46789601,64171,0.08760545100584036,0.07612095933263817,0.14898989898989898,0.09219613259668508,0.5056179775280899,0.27340823970037453,0.2209737827715356
Zip,39564,Mississippi,NA,4668,4415,4215,13298,110,117,317,544,10143162,18574803,124684229,153402194,210072.5,0.02356469580119966,0.026500566251415628,0.07520759193357059,0.04090840727929012,0.20220588235294118,0.21507352941176472,0.5827205882352942
Zip,39567,Mississippi,NA,1340,1184,1586,4110,41,61,205,307,2332820,4882871,42742722,49958413,117110,0.030597014925373135,0.05152027027027027,0.12925598991172763,0.07469586374695864,0.13355048859934854,0.1986970684039088,0.6677524429967426
Zip,39571,Mississippi,NA,1524,1517,1527,4568,118,182,241,541,12182132,26332752,69577238,108092122,162649,0.07742782152230972,0.11997363216875412,0.15782580222658807,0.11843257443082311,0.21811460258780038,0.3364140480591497,0.4454713493530499
Zip,39572,Mississippi,NA,161,159,161,481,26,52,77,155,1358321,4256867,14038733,19653921,111421,0.16149068322981366,0.3270440251572327,0.4782608695652174,0.32224532224532226,0.16774193548387098,0.33548387096774196,0.4967741935483871
Zip,39581,Mississippi,NA,1161,1313,910,3384,11,25,80,116,623323,1999911,15383368,18006602,127973.5,0.009474590869939707,0.01904036557501904,0.08791208791208792,0.034278959810874705,0.09482758620689655,0.21551724137931033,0.6896551724137931
Zip,70030,Louisiana,NA,395,402,400,1197,381,388,394,1163,49640652,71316317,106835894,227792863,184450,0.9645569620253165,0.9651741293532339,0.985,0.9715956558061821,0.3276010318142734,0.3336199484092863,0.33877901977644026
Zip,70036,Louisiana,NA,127,118,119,364,126,114,115,355,13117342,16754359,25599913,55471614,144927,0.9921259842519685,0.9661016949152542,0.9663865546218487,0.9752747252747253,0.35492957746478876,0.3211267605633803,0.323943661971831
Zip,70039,Louisiana,NA,118,116,112,346,107,111,109,327,15910367,22007171,32658752,70576290,193771,0.9067796610169492,0.9568965517241379,0.9732142857142857,0.9450867052023122,0.327217125382263,0.3394495412844037,0.3333333333333333
Zip,70051,Louisiana,NA,82,122,104,308,36,5,71,112,3775068,578445,13529248,17882761,142193,0.43902439024390244,0.040983606557377046,0.6826923076923077,0.36363636363636365,0.32142857142857145,0.044642857142857144,0.6339285714285714
Zip,70057,Louisiana,NA,240,268,238,746,23,15,91,129,3483333,3546976,29007804,36038113,285854,0.09583333333333334,0.055970149253731345,0.38235294117647056,0.17292225201072386,0.17829457364341086,0.11627906976744186,0.7054263565891473
Zip,70067,Louisiana,NA,293,304,272,869,290,300,262,852,28775452,40343126,57972429,127091007,131869.5,0.9897610921501706,0.9868421052631579,0.9632352941176471,0.9804372842347526,0.3403755868544601,0.352112676056338,0.3075117370892019
Zip,70068,Louisiana,NA,3299,3304,3334,9937,1110,1174,1836,4120,101522974,158038546,360743002,620304522,152413.5,0.3364655956350409,0.3553268765133172,0.5506898620275945,0.4146120559525008,0.26941747572815533,0.2849514563106796,0.44563106796116503
Zip,70070,Louisiana,NA,1143,1209,1228,3580,854,1152,1183,3189,141879632,257502842,385058552,784441026,234764,0.7471566054243219,0.9528535980148883,0.9633550488599348,0.8907821229050279,0.2677955471934776,0.36124176857949203,0.37096268422703044
Zip,70071,Louisiana,NA,316,314,310,940,36,17,58,111,4712677,2845360,15646425,23204462,180122,0.11392405063291139,0.054140127388535034,0.1870967741935484,0.11808510638297873,0.32432432432432434,0.15315315315315314,0.5225225225225225
Zip,70072,Louisiana,NA,5552,5515,5551,16618,27,51,157,235,2785669,6787419,34267250,43840338,165271,0.004863112391930836,0.009247506799637352,0.028283192217618446,0.014141292574317005,0.1148936170212766,0.2170212765957447,0.6680851063829787
Zip,70080,Louisiana,NA,75,75,77,227,74,74,72,220,10672846,12337029,17200075,40209950,166625.5,0.9866666666666667,0.9866666666666667,0.935064935064935,0.9691629955947136,0.33636363636363636,0.33636363636363636,0.32727272727272727
Zip,70084,Louisiana,NA,559,493,525,1577,44,43,107,194,3074346,4109474,18051905,25235725,124658,0.07871198568872988,0.0872210953346856,0.2038095238095238,0.12301838934686113,0.2268041237113402,0.22164948453608246,0.5515463917525774
Zip,70090,Louisiana,NA,727,693,772,2192,286,296,315,897,35695350,44377713,61359087,141432150,149470,0.39339752407152684,0.42712842712842713,0.40803108808290156,0.4092153284671533,0.3188405797101449,0.32998885172798215,0.3511705685618729
Zip,70124,Louisiana,NA,25,919,6910,7854,0,3,100,103,0,708973,43083553,43792526,422486,0,0.003264417845484222,0.01447178002894356,0.013114336643748408,0,0.02912621359223301,0.970873786407767
Zip,70129,Louisiana,NA,1979,391,61,2431,46,314,60,420,5278392,69980159,21856357,97114908,233318,0.023244062657908033,0.80306905370844,0.9836065573770492,0.17276840806252572,0.10952380952380952,0.7476190476190476,0.14285714285714285
Zip,70301,Louisiana,NA,4490,4448,4542,13480,1975,1434,1683,5092,197144940,218438985,465394980,880978905,147496,0.4398663697104677,0.32239208633093525,0.3705416116248349,0.3777448071216617,0.38786331500392773,0.28161822466614295,0.3305184603299293
Zip,70339,Louisiana,NA,490,476,487,1453,474,453,472,1399,51068903,59814895,106664526,217548324,130332,0.9673469387755103,0.9516806722689075,0.9691991786447639,0.9628355127322781,0.3388134381701215,0.32380271622587564,0.33738384560400286
Zip,70341,Louisiana,NA,205,192,187,584,20,54,60,134,2548834,8175182,12624026,23348042,162187.5,0.0975609756097561,0.28125,0.32085561497326204,0.22945205479452055,0.14925373134328357,0.40298507462686567,0.44776119402985076
Zip,70343,Louisiana,NA,524,553,589,1666,468,421,201,1090,57402443,66888813,45574024,169865280,146538,0.8931297709923665,0.7613019891500904,0.34125636672325976,0.6542617046818727,0.42935779816513764,0.38623853211009174,0.18440366972477065
Zip,70344,Louisiana,NA,621,648,625,1894,592,601,598,1791,57028669,70238459,87977667,215244795,116697,0.9533011272141707,0.9274691358024691,0.9568,0.9456177402323126,0.3305415968732552,0.33556672250139585,0.33389168062534896
Zip,70353,Louisiana,NA,126,138,135,399,122,127,131,380,11724687,14413893,17526905,43665485,113533.5,0.9682539682539683,0.9202898550724637,0.9703703703703703,0.9523809523809523,0.32105263157894737,0.33421052631578946,0.3447368421052632
Zip,70355,Louisiana,NA,102,113,108,323,102,113,108,323,7995050,12495969,23868431,44359450,113516,1,1,1,1,0.3157894736842105,0.3498452012383901,0.33436532507739936
Zip,70356,Louisiana,NA,229,234,226,689,212,214,222,648,19487175,26373275,58816058,104676508,122695.5,0.925764192139738,0.9145299145299145,0.9823008849557522,0.9404934687953556,0.3271604938271605,0.33024691358024694,0.3425925925925926
Zip,70357,Louisiana,NA,353,356,355,1064,13,4,131,148,1026699,407912,54975046,56409657,411592,0.036827195467422094,0.011235955056179775,0.36901408450704226,0.13909774436090225,0.08783783783783784,0.02702702702702703,0.8851351351351351
Zip,70359,Louisiana,NA,860,1024,650,2534,350,483,344,1177,34466311,72588671,77605808,184660790,153230,0.4069767441860465,0.4716796875,0.5292307692307693,0.4644830307813733,0.2973661852166525,0.4103653355989805,0.29226847918436705
Zip,70360,Louisiana,NA,886,1706,5121,7713,566,834,3659,5059,61874202,120858282,1121942791,1304675275,234559,0.6388261851015802,0.488862837045721,0.7145088849834017,0.6559056138986127,0.11187981814587863,0.16485471437042895,0.7232654674836925
Zip,70363,Louisiana,NA,4226,2230,542,6998,2645,1234,214,4093,246470512,175615887,46530068,468616467,110942,0.6258873639375295,0.5533632286995516,0.3948339483394834,0.5848813946841955,0.6462252626435377,0.3014903493769851,0.052284387979477154
Zip,70364,Louisiana,NA,2638,3617,2233,8488,1678,2694,1734,6106,160772609,409749188,367149669,937671466,155590.5,0.6360879454131918,0.7448161459773293,0.7765338110165696,0.719368520263902,0.2748116606616443,0.4412053717654766,0.2839829675728791
Zip,70373,Louisiana,NA,802,760,681,2243,240,307,358,905,19843247,38640825,73514220,131998292,133329,0.29925187032418954,0.4039473684210526,0.5256975036710719,0.403477485510477,0.26519337016574585,0.3392265193370166,0.39558011049723757
Zip,70374,Louisiana,NA,708,745,754,2207,537,556,556,1649,47670177,74804423,127948652,250423252,134290,0.7584745762711864,0.7463087248322148,0.7374005305039788,0.7471681014952424,0.32565191024863555,0.33717404487568226,0.33717404487568226
Zip,70377,Louisiana,NA,441,416,412,1269,420,378,397,1195,35633066,42432580,59574007,137639653,111095,0.9523809523809523,0.9086538461538461,0.9635922330097088,0.9416863672182821,0.3514644351464435,0.3163179916317992,0.3322175732217573
Zip,70380,Louisiana,NA,1661,1564,1558,4783,294,366,396,1056,22004423,37515964,81927916,141448303,108575,0.177001806140879,0.2340153452685422,0.25417201540436457,0.22078193602341625,0.2784090909090909,0.3465909090909091,0.375
Zip,70390,Louisiana,NA,360,377,377,1114,50,54,6,110,4558878,6342212,1268773,12169863,106550.5,0.1388888888888889,0.14323607427055704,0.015915119363395226,0.09874326750448834,0.45454545454545453,0.4909090909090909,0.05454545454545454
Zip,70394,Louisiana,NA,1625,1629,1594,4848,924,748,894,2566,81835109,101203427,194135520,377174056,134483.5,0.5686153846153846,0.45917740945365254,0.560853199498118,0.5292904290429042,0.36009353078721745,0.2915042868277475,0.34840218238503506
Zip,70395,Louisiana,NA,476,506,507,1489,290,131,116,537,31292467,18526059,28740614,78559140,122570,0.6092436974789915,0.25889328063241107,0.22879684418145957,0.36064472800537273,0.5400372439478585,0.24394785847299813,0.21601489757914338
Zip,70397,Louisiana,NA,146,147,146,439,143,141,135,419,16749297,20942934,26632588,64324819,149065,0.9794520547945206,0.9591836734693877,0.9246575342465754,0.9544419134396356,0.3412887828162291,0.33651551312649164,0.3221957040572792
Zip,70433,Louisiana,NA,4775,4138,4960,13873,49,102,195,346,7515361,22537849,97841941,127895151,287273.5,0.010261780104712043,0.024649589173513776,0.03931451612903226,0.024940531968572047,0.1416184971098266,0.2947976878612717,0.5635838150289018
Zip,70445,Louisiana,NA,1712,1448,1402,4562,164,156,233,553,17382914,23325671,70513324,111221909,158485,0.09579439252336448,0.10773480662983426,0.16619115549215407,0.12121876370013152,0.2965641952983725,0.2820976491862568,0.4213381555153707
Zip,70447,Louisiana,NA,1515,1513,1517,4545,329,173,147,649,63146895,44514920,89016777,196678592,232425,0.21716171617161717,0.11434236615994713,0.09690177982860909,0.1427942794279428,0.5069337442218799,0.2665639445300462,0.22650231124807396
Zip,70448,Louisiana,NA,3804,3668,2296,9768,163,173,265,601,27442930,43433437,154655040,225531407,281551,0.042849631966351207,0.04716466739367503,0.11541811846689895,0.06152743652743653,0.27121464226289516,0.2878535773710483,0.44093178036605657
Zip,70449,Louisiana,NA,309,324,323,956,221,176,134,531,33608652,31909883,44675879,110194414,175768,0.7152103559870551,0.5432098765432098,0.4148606811145511,0.555439330543933,0.416195856873823,0.3314500941619586,0.2523540489642185
Zip,70454,Louisiana,NA,2712,2686,2534,7932,60,45,47,152,7604599,7268082,11271378,26144059,156281.5,0.022123893805309734,0.01675353685778109,0.018547750591949488,0.019162884518406455,0.39473684210526316,0.29605263157894735,0.3092105263157895
Zip,70458,Louisiana,NA,5477,6075,3667,15219,3032,1286,1090,5408,355547237,264816411,414067838,1034431486,136847.5,0.5535877305094029,0.2116872427983539,0.2972457049359149,0.35534529206912413,0.5606508875739645,0.2377958579881657,0.2015532544378698
Zip,70460,Louisiana,NA,4398,2337,1951,8686,702,370,375,1447,78243570,56741549,107011726,241996845,134706,0.15961800818553887,0.15832263585793752,0.1922091235263967,0.16658991480543403,0.4851416724257084,0.25570145127850724,0.2591568762957844
Zip,70461,Louisiana,NA,2113,2464,5183,9760,313,211,624,1148,33359522,33002423,222098828,288460773,201680,0.14813061997160434,0.08563311688311688,0.12039359444337257,0.11762295081967213,0.27264808362369336,0.1837979094076655,0.5435540069686411
Zip,70462,Louisiana,NA,207,667,340,1214,71,163,95,329,11154513,33047144,25884387,70086044,207615,0.34299516908212563,0.24437781109445278,0.27941176470588236,0.27100494233937394,0.21580547112462006,0.49544072948328266,0.2887537993920973
Zip,70471,Louisiana,NA,2333,2179,3536,8048,27,94,121,242,4981187,23459458,95371308,123811953,305520.5,0.011573081868838405,0.043139054612207434,0.034219457013574664,0.030069582504970178,0.1115702479338843,0.3884297520661157,0.5
Zip,70510,Louisiana,NA,2e3,1944,1898,5842,202,512,198,912,15665609,54152883,32161545,101980037,104265,0.101,0.26337448559670784,0.10432033719704953,0.156110920917494,0.22149122807017543,0.5614035087719298,0.21710526315789475
Zip,70528,Louisiana,NA,212,232,160,604,94,126,94,314,6353416,9971011,12978385,29302812,74759,0.44339622641509435,0.5431034482758621,0.5875,0.5198675496688742,0.29936305732484075,0.4012738853503185,0.29936305732484075
Zip,70533,Louisiana,NA,563,600,645,1808,457,373,264,1094,35450956,47442692,42936269,125829917,119033,0.8117229129662522,0.6216666666666667,0.40930232558139534,0.6050884955752213,0.41773308957952465,0.34095063985374774,0.2413162705667276
Zip,70538,Louisiana,NA,1104,1121,1073,3298,385,492,332,1209,23950519,43109748,59100924,126161191,80540,0.348731884057971,0.43889384478144516,0.30941286113699906,0.36658580958156456,0.3184449958643507,0.40694789081885857,0.2746071133167907
Zip,70542,Louisiana,NA,321,315,314,950,190,194,221,605,14872925,17345820,29659959,61878704,89829,0.5919003115264797,0.6158730158730159,0.7038216560509554,0.6368421052631579,0.3140495867768595,0.32066115702479336,0.3652892561983471
Zip,70544,Louisiana,NA,1001,960,1039,3e3,14,55,42,111,909962,4361734,5554991,10826687,82575,0.013986013986013986,0.057291666666666664,0.04042348411934552,0.037,0.12612612612612611,0.4954954954954955,0.3783783783783784
Zip,70548,Louisiana,NA,972,933,867,2772,63,111,104,278,4784511,11290667,13767590,29842768,110131.5,0.06481481481481481,0.1189710610932476,0.11995386389850057,0.10028860028860029,0.22661870503597123,0.39928057553956836,0.37410071942446044
Zip,70549,Louisiana,NA,366,332,307,1005,50,47,91,188,2609041,4695940,20911004,28215985,120271.5,0.1366120218579235,0.14156626506024098,0.2964169381107492,0.18706467661691542,0.26595744680851063,0.25,0.48404255319148937
Zip,70560,Louisiana,NA,5068,3035,2146,10249,473,319,146,938,33405953,32235711,24438332,90079996,77034.5,0.09333070244672455,0.10510708401976936,0.06803355079217148,0.09152112401209875,0.5042643923240938,0.3400852878464819,0.15565031982942432
Zip,70582,Louisiana,NA,2390,2363,654,5407,70,76,9,155,8193972,10920329,1450355,20564656,137765,0.029288702928870293,0.03216250528988574,0.013761467889908258,0.028666543369705935,0.45161290322580644,0.49032258064516127,0.05806451612903226
Zip,70601,Louisiana,NA,4296,1981,790,7067,21,47,62,130,1776340,7944703,21790593,31511636,199893.5,0.004888268156424581,0.023725391216557295,0.07848101265822785,0.018395358709494835,0.16153846153846155,0.36153846153846153,0.47692307692307695
Zip,70605,Louisiana,NA,490,3144,5255,8889,33,56,132,221,2912041,9259561,54614092,66785694,245126,0.0673469387755102,0.017811704834605598,0.025118934348239773,0.024862189222634716,0.1493212669683258,0.25339366515837103,0.5972850678733032
Zip,70607,Louisiana,NA,2496,1862,714,5072,210,226,115,551,20935690,36041140,35094803,92071633,143047,0.08413461538461539,0.12137486573576799,0.16106442577030813,0.10863564668769717,0.3811252268602541,0.4101633393829401,0.20871143375680581
Zip,70631,Louisiana,NA,51,48,51,150,48,43,47,138,4718078,6607710,12804372,24130160,154716,0.9411764705882353,0.8958333333333334,0.9215686274509803,0.92,0.34782608695652173,0.3115942028985507,0.34057971014492755
Zip,70645,Louisiana,NA,104,104,104,312,91,86,77,254,8677384,11159995,16016297,35853676,125757,0.875,0.8269230769230769,0.7403846153846154,0.8141025641025641,0.35826771653543305,0.33858267716535434,0.3031496062992126
Zip,70665,Louisiana,NA,531,685,1441,2657,36,67,136,239,3914738,10908717,52117521,66940976,198191,0.06779661016949153,0.09781021897810219,0.09437890353920889,0.0899510726383139,0.1506276150627615,0.2803347280334728,0.5690376569037657
Zip,70726,Louisiana,NA,5066,4796,4487,14349,17,49,34,100,2458896,8434095,8092514,18985505,172575,0.003355704697986577,0.010216847372810676,0.007577445954981056,0.006969126768415918,0.17,0.49,0.34
Zip,70737,Louisiana,NA,5002,4936,4981,14919,444,219,467,1130,68410962,41775112,130107435,240293509,191096,0.08876449420231908,0.0443679092382496,0.09375627384059426,0.07574234198002547,0.3929203539823009,0.19380530973451326,0.41327433628318583
Zip,70763,Louisiana,NA,295,296,322,913,86,65,121,272,11255134,11686458,31474182,54415774,188858.5,0.29152542372881357,0.2195945945945946,0.37577639751552794,0.29791894852135814,0.3161764705882353,0.23897058823529413,0.44485294117647056
Zip,70764,Louisiana,NA,1457,1455,1461,4373,149,164,113,426,12980249,19625947,18351572,50957768,114803.5,0.10226492793411118,0.11271477663230241,0.07734428473648186,0.09741596158243769,0.34976525821596244,0.38497652582159625,0.2652582159624413
Zip,70769,Louisiana,NA,4690,4849,4933,14472,62,53,20,135,9817419,11098580,7576509,28492508,193501,0.013219616204690832,0.010930088678077954,0.004054327995134806,0.009328358208955223,0.45925925925925926,0.3925925925925926,0.14814814814814814
Zip,70774,Louisiana,NA,1298,1284,1271,3853,754,827,802,2383,116045918,158285804,230399843,504731565,190308,0.5808936825885979,0.6440809968847352,0.6309992132179386,0.6184791071892032,0.31640788921527485,0.34704154427192613,0.33655056651279897
Zip,70778,Louisiana,NA,408,288,282,978,401,179,63,643,61173635,34175355,17331989,112680979,164697,0.9828431372549019,0.6215277777777778,0.22340425531914893,0.6574642126789366,0.6236391912908242,0.27838258164852253,0.09797822706065319
Zip,70810,Louisiana,NA,1946,4245,7812,14003,1,1,99,101,155461,207321,26538229,26901011,241429,5.138746145940391e-4,2.3557126030624264e-4,0.012672811059907835,0.007212740127115618,0.009900990099009901,0.009900990099009901,0.9801980198019802
Zip,77058,Texas,NA,1640,1856,701,4197,142,42,171,355,12198951,7108165,71096834,90403950,235679,0.08658536585365853,0.022629310344827586,0.24393723252496433,0.08458422682868716,0.4,0.11830985915492957,0.48169014084507045
Zip,77414,Texas,NA,2628,2603,2521,7752,68,79,204,351,6698671,10251853,44227416,61177940,167127,0.0258751902587519,0.03034959661928544,0.08092026973423244,0.045278637770897835,0.19373219373219372,0.22507122507122507,0.5811965811965812
Zip,77422,Texas,NA,1917,1855,1850,5622,191,152,109,452,16261816,19413523,24869869,60545208,117554,0.09963484611371935,0.08194070080862534,0.05891891891891892,0.08039843472073994,0.4225663716814159,0.336283185840708,0.2411504424778761
Zip,77457,Texas,NA,162,292,248,702,100,235,189,524,12144502,43950299,64623934,120718735,199286.5,0.6172839506172839,0.8047945205479452,0.7620967741935484,0.7464387464387464,0.19083969465648856,0.4484732824427481,0.3606870229007634
Zip,77465,Texas,NA,880,834,826,2540,26,36,45,107,1696403,3895331,9785882,15377616,118477,0.029545454545454545,0.04316546762589928,0.05447941888619855,0.04212598425196851,0.24299065420560748,0.3364485981308411,0.4205607476635514
Zip,77514,Texas,NA,655,637,648,1940,83,123,64,270,8073561,16895471,18887421,43856453,135941.5,0.1267175572519084,0.19309262166405022,0.09876543209876543,0.13917525773195877,0.3074074074074074,0.45555555555555555,0.23703703703703705
Zip,77515,Texas,NA,3397,3476,2918,9791,254,55,12,321,25057370,9386975,3738232,38182577,107624,0.07477185752134236,0.015822784810126583,0.00411240575736806,0.03278521090797672,0.7912772585669782,0.17133956386292834,0.037383177570093455
Zip,77520,Texas,NA,5975,2917,1823,10715,34,29,68,131,3334293,3756197,17515640,24606130,153772,0.005690376569037657,0.00994172094617758,0.03730115194733955,0.012225851609892674,0.2595419847328244,0.22137404580152673,0.5190839694656488
Zip,77539,Texas,NA,4263,6671,3325,14259,431,433,427,1291,36296562,58411754,141842642,236550958,137193,0.10110250996950504,0.06490780992354969,0.12842105263157894,0.09053930850690792,0.3338497288923315,0.3353989155693261,0.3307513555383424
Zip,77541,Texas,NA,2741,2592,2126,7459,1023,946,616,2585,115970655,164689841,165855756,446516252,147807,0.37322145202480844,0.36496913580246915,0.28974600188146754,0.3465612012334093,0.39574468085106385,0.3659574468085106,0.23829787234042554
Zip,77550,Texas,NA,3574,3594,2224,9392,577,784,1015,2376,70264210,157301278,463036645,690602133,220925,0.16144376049244544,0.21814134668892599,0.45638489208633093,0.25298126064735943,0.24284511784511784,0.32996632996632996,0.4271885521885522
Zip,77551,Texas,NA,3425,2434,968,6827,1045,438,118,1601,122780674,77086473,63160547,263027694,140213,0.3051094890510949,0.1799506984387839,0.12190082644628099,0.23451003368976125,0.6527170518425984,0.273579013116802,0.07370393504059962
Zip,77554,Texas,NA,1535,2485,5336,9356,968,1989,4247,7204,209876557,516160802,2145537992,2871575351,338458,0.6306188925081433,0.8004024144869215,0.7959145427286357,0.7699871740059855,0.13436979455857856,0.27609661299278176,0.5895335924486397
Zip,77563,Texas,NA,1354,1386,1307,4047,556,574,526,1656,86776419,115425654,195441035,397643108,224579.5,0.41063515509601184,0.41414141414141414,0.4024483550114767,0.40919199406968126,0.3357487922705314,0.3466183574879227,0.3176328502415459
Zip,77565,Texas,NA,436,890,1105,2431,114,184,252,550,16694623,42887459,126717870,186299952,277815,0.26146788990825687,0.20674157303370785,0.22805429864253393,0.22624434389140272,0.20727272727272728,0.33454545454545453,0.4581818181818182
Zip,77568,Texas,NA,2021,2019,1909,5949,0,0,227,227,0,0,65478589,65478589,271612,0,0,0.11891042430591933,0.038157673558581275,0,0,1
Zip,77571,Texas,NA,4080,4099,4108,12287,24,65,88,177,3195824,12055587,23915061,39166472,200319,0.0058823529411764705,0.015857526225908757,0.021421616358325218,0.014405469195084236,0.13559322033898305,0.3672316384180791,0.4971751412429379
Zip,77573,Texas,NA,8450,8569,8511,25530,97,22,34,153,12012810,4784007,36329763,53126580,153165,0.011479289940828403,0.0025673940949935813,0.003994830219715662,0.005992949471210341,0.6339869281045751,0.1437908496732026,0.2222222222222222
Zip,77586,Texas,NA,2566,2673,2430,7669,266,82,191,539,26002520,16774264,87005164,129781948,176074,0.10366328916601715,0.0306771417882529,0.07860082304526748,0.07028295736080323,0.4935064935064935,0.15213358070500926,0.35435992578849723
Zip,77611,Texas,NA,1164,1141,1118,3423,216,231,283,730,18260588,30156126,67108454,115525168,134472,0.18556701030927836,0.20245398773006135,0.25313059033989266,0.21326321939818874,0.2958904109589041,0.31643835616438354,0.38767123287671235
Zip,77617,Texas,NA,99,115,133,347,97,105,115,317,13980701,24046400,49385410,87412511,232989,0.9797979797979798,0.9130434782608695,0.8646616541353384,0.9135446685878963,0.305993690851735,0.3312302839116719,0.3627760252365931
Zip,77630,Texas,NA,4470,4313,2061,10844,743,481,239,1463,40512410,45578570,29132953,115223933,62220,0.16621923937360178,0.11152330164618594,0.11596312469674915,0.1349133161195131,0.5078605604921395,0.3287764866712235,0.16336295283663704
Zip,77650,Texas,NA,1224,1263,1267,3754,1045,933,793,2771,166390376,224871810,338287001,729549187,228471,0.8537581699346405,0.7387173396674585,0.6258879242304657,0.7381459776238679,0.3771201732226633,0.3367015517863587,0.286178274990978
Zip,77705,Texas,NA,4862,2869,2400,10131,78,188,121,387,5116689,17700117,20718446,43535252,99087,0.016042780748663103,0.0655280585569885,0.050416666666666665,0.03819958543085579,0.20155038759689922,0.48578811369509045,0.31266149870801035
Zip,77982,Texas,NA,309,344,352,1005,65,126,183,374,8268142,21967735,76245385,106481262,210614,0.21035598705501618,0.36627906976744184,0.5198863636363636,0.37213930348258706,0.17379679144385027,0.33689839572192515,0.4893048128342246
Zip,78336,Texas,NA,1743,1419,1382,4544,95,142,216,453,7971538,18273475,87644429,113889442,153301,0.05450372920252438,0.10007047216349542,0.15629522431259044,0.0996919014084507,0.2097130242825607,0.31346578366445915,0.4768211920529801
Zip,78362,Texas,NA,1091,1091,1056,3238,38,53,72,163,4998142,10036517,23550743,38585402,214705,0.034830430797433545,0.04857928505957837,0.06818181818181818,0.05033971587399629,0.2331288343558282,0.32515337423312884,0.44171779141104295
Zip,78373,Texas,NA,1567,1636,2169,5372,998,942,1070,3010,167408121,279545720,531356643,978310484,266885,0.6368857689853222,0.5757946210268948,0.49331489165514064,0.560312732688012,0.3315614617940199,0.3129568106312292,0.3554817275747508
Zip,78382,Texas,NA,3865,4054,4091,12010,518,1105,1740,3363,54614437,195867219,891258085,1141739741,239009,0.13402328589909443,0.27257030093734586,0.42532388169151797,0.28001665278934224,0.15402914064823076,0.32857567647933394,0.5173951828724354
Zip,78402,Texas,NA,472,128,92,692,470,123,71,664,30278065,17527287,17963995,65769347,60414,0.9957627118644068,0.9609375,0.7717391304347826,0.9595375722543352,0.70783132530120485,0.1852409638554217,0.10692771084337349
Zip,78418,Texas,NA,1998,3863,7071,12932,260,444,1642,2346,25501810,61588910,568710976,655801696,226555.5,0.13013013013013014,0.11493657778928294,0.2322160939046811,0.1814104546860501,0.11082693947144075,0.18925831202046037,0.6999147485080989
Zip,78578,Texas,NA,1499,1474,1462,4435,522,486,478,1486,45063828,64800927,121058623,230923378,127199.5,0.3482321547698466,0.32971506105834464,0.32694938440492477,0.3350620067643743,0.351278600269179,0.32705248990578734,0.32166890982503366
Zip,78597,Texas,NA,2345,2352,2385,7082,1076,900,716,2692,157282802,227344397,405138390,789765589,219362.5,0.45884861407249466,0.3826530612244898,0.30020964360587005,0.38011861056198815,0.399702823179792,0.3343239227340267,0.2659732540861813
Zip,78598,Texas,NA,141,148,145,434,30,43,69,142,1610045,2914559,9710553,14235157,84644.5,0.2127659574468085,0.2905405405405405,0.47586206896551725,0.3271889400921659,0.2112676056338028,0.3028169014084507,0.4859154929577465
Zip,90265,California,NA,2392,2377,2443,7212,27,86,134,247,48470765,260999228,1139409107,1448879100,5368798,0.0112876254180602,0.0361800588977703,0.05485059353254196,0.03424847476428175,0.10931174089068826,0.3481781376518219,0.5425101214574899
Zip,90740,California,NA,1695,1728,1927,5350,291,292,336,919,162974991,265477964,424001040,852453995,914830,0.17168141592920355,0.16898148148148148,0.1743642968344577,0.17177570093457945,0.31664853101196955,0.3177366702937976,0.36561479869423286
Zip,90742,California,NA,18,36,227,281,15,24,103,142,8626550,18962934,128175466,155764950,1025716,0.8333333333333334,0.6666666666666666,0.45374449339207046,0.505338078291815,0.1056338028169014,0.16901408450704225,0.7253521126760564
Zip,90803,California,NA,1185,966,7454,9605,312,336,4297,4945,128216145,190238011,5724046228,6042500384,1080994,0.26329113924050634,0.34782608695652173,0.5764690099275557,0.5148360229047371,0.06309403437815976,0.0679474216380182,0.868958543983822
Zip,91932,California,NA,1433,1425,1434,4292,127,52,132,311,53066611,25885582,94149766,173101959,500098,0.08862526168876483,0.036491228070175435,0.09205020920502092,0.07246039142590867,0.40836012861736337,0.16720257234726688,0.42443729903536975
Zip,92109,California,NA,1809,2360,7169,11338,53,267,1220,1540,22227005,156420266,1525801559,1704448830,943013.5,0.029297954671088998,0.11313559322033899,0.17017715162505231,0.1358264244134768,0.03441558441558441,0.17337662337662338,0.7922077922077922
Zip,92118,California,NA,2205,2207,2326,6738,261,141,610,1012,282685053,229928266,1695384403,2207997722,2052485,0.11836734693877551,0.06388763026733121,0.2622527944969905,0.1501929355891956,0.25790513833992096,0.13932806324110672,0.6027667984189723
Zip,92646,California,NA,6465,7813,5477,19755,3609,5396,3845,12850,1856272657,4292473180,3707324004,9856069841,801950.5,0.5582366589327146,0.690643798796877,0.7020266569289757,0.6504682358896482,0.2808560311284047,0.41992217898832684,0.2992217898832685
Zip,92647,California,NA,5451,5354,1606,12411,599,2515,691,3805,264162561,1937430003,651605799,2853198363,761542,0.10988809392771968,0.46974224878595444,0.4302615193026152,0.3065828700346467,0.15742444152431012,0.6609724047306176,0.18160315374507227
Zip,92648,California,NA,3446,2447,7384,13277,411,400,584,1395,250518694,297826900,647248209,1195593803,778569,0.11926871735345328,0.1634654679199019,0.0790899241603467,0.10506891617082172,0.2946236559139785,0.2867383512544803,0.41863799283154124
Zip,92649,California,NA,3581,3428,4237,11246,671,2142,2548,5361,356973233,1631309401,3947672662,5935955296,844913,0.1873778274225077,0.6248541423570595,0.6013688930847297,0.4767028276720612,0.1251632158179444,0.39955232232792387,0.4752844618541317
Zip,92660,California,NA,3637,3255,3239,10131,41,20,238,299,49738546,33746893,878444457,961929896,3033583,0.011273027220236459,0.006144393241167435,0.07347946897190491,0.029513374790247755,0.13712374581939799,0.06688963210702341,0.7959866220735786
Zip,92661,California,NA,184,642,938,1764,156,535,594,1285,167211049,909037890,1822074041,2898322980,1968064,0.8478260869565217,0.8333333333333334,0.6332622601279317,0.7284580498866213,0.12140077821011673,0.4163424124513619,0.4622568093385214
Zip,92662,California,NA,74,773,347,1194,73,772,345,1190,96746030,1281812225,989027425,2367585680,1732512.5,0.9864864864864865,0.9987063389391979,0.9942363112391931,0.9966499162479062,0.06134453781512605,0.6487394957983194,0.28991596638655465
Zip,92663,California,NA,3069,1777,1960,6806,714,711,281,1706,805967148,1154626354,837183883,2797777385,1467913,0.23264907135874877,0.4001125492402926,0.1433673469387755,0.25066118131060827,0.41852286049237986,0.4167643610785463,0.16471277842907386
Zip,93001,California,NA,3617,1438,3839,8894,218,15,329,562,97147710,8177987,557661593,662987290,1077983.5,0.06027094277025159,0.01043115438108484,0.0856994008856473,0.06318866651675287,0.3879003558718861,0.026690391459074734,0.5854092526690391
Zip,93013,California,NA,1746,1739,1661,5146,141,85,134,360,86553878,67316164,466690314,620560356,768340.5,0.08075601374570447,0.0488786658999425,0.0806742925948224,0.06995724834823164,0.39166666666666666,0.2361111111111111,0.37222222222222223
Zip,93035,California,NA,1074,2605,6530,10209,1,16,1042,1059,393384,8059948,975868886,984322218,847687,9.31098696461825e-4,0.006142034548944338,0.15957120980091882,0.10373200117543344,9.442870632672333e-4,0.015108593012275733,0.983947119924457
Zip,95503,California,NA,2457,2093,3582,8132,178,51,22,251,37519332,13396806,9072811,59988949,218819,0.07244607244607244,0.024366937410415672,0.006141820212171971,0.0308657156910969,0.7091633466135459,0.20318725099601595,0.08764940239043825
Zip,96701,Hawaii,NA,4210,4106,4198,12514,0,146,33,179,0,101725838,35306798,137032636,708881,0,0.035557720409157334,0.00786088613625536,0.014303979542911939,0,0.8156424581005587,0.18435754189944134
Zip,96706,Hawaii,NA,5660,5689,5660,17009,177,121,359,657,80412601,70356801,387808614,538578016,700094,0.03127208480565371,0.021269115837581298,0.06342756183745583,0.03862660944206009,0.2694063926940639,0.1841704718417047,0.5464231354642314
Zip,96717,Hawaii,NA,452,431,436,1319,164,151,200,515,43830482,95530076,232222936,371583494,655801,0.36283185840707965,0.3503480278422274,0.45871559633027525,0.3904473085670963,0.31844660194174756,0.29320388349514565,0.3883495145631068
Zip,96734,Hawaii,NA,4306,4309,4330,12945,582,347,273,1202,446181018,351181078,410557151,1207919247,925565.5,0.13516024152345565,0.08052912508702716,0.06304849884526559,0.09285438393202008,0.4841930116472546,0.28868552412645593,0.2271214642262895
Zip,96743,Hawaii,NA,1148,1167,1967,4282,9,34,61,104,5133746,35186658,207815255,248135659,1728636.5,0.0078397212543554,0.02913453299057412,0.031011692933401117,0.024287716020551145,0.08653846153846154,0.3269230769230769,0.5865384615384616
Zip,96744,Hawaii,NA,5153,5155,5164,15472,35,76,329,440,23721937,63671482,452036583,539430002,1075931.5,0.0067921599068503785,0.014742967992240542,0.06371030209140201,0.02843846949327818,0.07954545454545454,0.17272727272727273,0.7477272727272727
Zip,96746,Hawaii,NA,2249,2250,2270,6769,380,74,57,511,130698334,45821324,56610832,233130490,437654,0.16896398399288573,0.03288888888888889,0.025110132158590308,0.07549120992761117,0.7436399217221135,0.14481409001956946,0.11154598825831702
Zip,96748,Hawaii,NA,566,598,581,1745,307,212,201,720,70906520,75982491,119756326,266645337,322165.5,0.5424028268551236,0.35451505016722407,0.3459552495697074,0.41260744985673353,0.4263888888888889,0.29444444444444445,0.2791666666666667
Zip,96753,Hawaii,NA,4652,4644,5073,14369,86,208,102,396,33016873,128907434,134427042,296351349,577762,0.018486672398968184,0.04478897502153316,0.020106445890005913,0.02755932911128123,0.21717171717171718,0.5252525252525253,0.25757575757575757
Zip,96778,Hawaii,NA,1539,1645,1570,4754,4,14,107,125,588703,2473318,47661201,50723222,312573,0.002599090318388564,0.00851063829787234,0.06815286624203822,0.026293647454774926,0.032,0.112,0.856
Zip,96792,Hawaii,NA,3627,3621,3616,10864,55,202,156,413,17284097,77742427,105664773,200691297,406164,0.015164047422111939,0.055785694559513946,0.04314159292035398,0.03801546391752577,0.13317191283292978,0.4891041162227603,0.37772397094430993
Zip,96796,Hawaii,NA,173,202,270,645,46,45,51,142,17910308,20665585,40640658,79216551,457924.5,0.2658959537572254,0.22277227722772278,0.18888888888888888,0.22015503875968992,0.323943661971831,0.31690140845070425,0.3591549295774648
Zip,96797,Hawaii,NA,5473,5471,5470,16414,265,73,54,392,69028152,45461344,43816620,158306116,219467,0.04841951397770875,0.01334308170352769,0.009872029250457038,0.023882051906908737,0.6760204081632653,0.18622448979591838,0.1377551020408163
Zip,96813,Hawaii,NA,2814,3686,1452,7952,392,1130,121,1643,152936350,740223159,177086495,1070246004,588823,0.13930348258706468,0.30656538252848614,0.08333333333333333,0.20661468812877262,0.23858794887401097,0.6877662811929397,0.0736457699330493
Zip,96814,Hawaii,NA,5678,3170,1982,10830,1477,1947,1655,5079,542438726,1417490520,2464588672,4424517918,761934,0.2601268052131032,0.6141955835962145,0.8350151362260343,0.46897506925207755,0.2908052766292577,0.3833431777909037,0.32585154557983853
Zip,96815,Hawaii,NA,11998,8097,3673,23768,10787,5977,1474,18238,3466091684,3498533040,2501341732,9465966456,422154,0.8990665110851809,0.7381746325799678,0.40130683365096653,0.7673342308986874,0.5914573966443689,0.3277223379756552,0.08082026537997587
Zip,96816,Hawaii,NA,678,3693,9602,13973,0,0,124,124,0,0,495006736,495006736,3302322.5,0,0,0.012913976254946885,0.008874257496600587,0,0,1
Zip,96817,Hawaii,NA,3552,3987,3287,10826,126,122,1,249,51007942,63634218,1216454,115858614,464657,0.03547297297297297,0.030599448206671685,3.04228780042592e-4,0.02300018474043968,0.5060240963855421,0.4899598393574297,0.004016064257028112
Zip,96821,Hawaii,NA,0,766,5734,6500,0,69,515,584,0,56095017,1260036481,1316131498,1314180.5,0,0.09007832898172324,0.08981513777467737,0.08984615384615384,0,0.11815068493150685,0.8818493150684932
Zip,96825,Hawaii,NA,252,5349,5475,11076,0,312,415,727,0,239298825,698483172,937781997,986961,0,0.05832865956253505,0.07579908675799087,0.06563741422896352,0,0.42916093535075656,0.5708390646492435
Zip,96826,Hawaii,NA,4877,2906,963,8746,1639,1050,492,3181,606993371,650483216,855517226,2112993813,451399,0.33606725445970886,0.36132140399174123,0.5109034267912772,0.3637091241710496,0.5152467777428481,0.3300848789688777,0.15466834328827414
Zip,97016,Oregon,NA,690,686,680,2056,40,46,33,119,7133141,10222680,14404429,31760250,212794,0.057971014492753624,0.06705539358600583,0.04852941176470588,0.05787937743190662,0.33613445378151263,0.3865546218487395,0.2773109243697479
Zip,97103,Oregon,NA,1892,1894,1888,5674,238,94,92,424,45757048,25047678,34103815,104908541,229187,0.12579281183932348,0.04963041182682154,0.048728813559322036,0.07472682410997533,0.5613207547169812,0.22169811320754718,0.2169811320754717
Zip,97121,Oregon,NA,1,126,251,378,1,66,68,135,245296,14753568,20751810,35750674,259470,1,0.5238095238095238,0.27091633466135456,0.35714285714285715,0.007407407407407408,0.4888888888888889,0.5037037037037037
Zip,97131,Oregon,NA,955,571,371,1897,127,16,1,144,26457046,5272763,471794,32201603,212916,0.13298429319371727,0.028021015761821366,0.0026954177897574125,0.07590933052187665,0.8819444444444444,0.1111111111111111,0.006944444444444444
Zip,97138,Oregon,NA,1360,1702,1888,4950,119,59,28,206,26994447,16777844,13039952,56812243,255959.5,0.0875,0.03466509988249119,0.014830508474576272,0.041616161616161614,0.5776699029126213,0.28640776699029125,0.13592233009708737
Zip,97146,Oregon,NA,717,731,719,2167,447,152,27,626,95114507,42116744,11207729,148438980,231838.5,0.6234309623430963,0.2079343365253078,0.037552155771905425,0.28887863405629904,0.7140575079872205,0.24281150159744408,0.04313099041533546
Zip,97367,Oregon,NA,2203,2358,2168,6729,305,124,53,482,52536210,30941007,22120262,105597479,188500.5,0.13844757149341808,0.05258693808312129,0.024446494464944648,0.07163025709615099,0.6327800829875518,0.2572614107883817,0.10995850622406639
Zip,97394,Oregon,NA,1159,1106,1116,3381,150,30,48,228,24966081,6976918,18157950,50100949,174067.5,0.12942191544434858,0.027124773960216998,0.043010752688172046,0.06743566992014197,0.6578947368421053,0.13157894736842105,0.21052631578947367
Zip,97420,Oregon,NA,2749,2746,2768,8263,152,100,117,369,19015591,17831912,32425903,69273406,173625,0.05529283375773009,0.03641660597232338,0.04226878612716763,0.04465690427205615,0.41192411924119243,0.27100271002710025,0.3170731707317073
Zip,97467,Oregon,NA,837,799,758,2394,314,62,33,409,29994034,8535911,8341076,46871021,98790,0.3751493428912784,0.07759699624530664,0.04353562005277045,0.170843776106934,0.7677261613691931,0.15158924205378974,0.08068459657701711
Zip,98028,Washington,NA,2434,2426,2477,7337,133,0,10,143,43102154,0,19322482,62424636,325829,0.05464256368118324,0,0.004037141703673799,0.019490254872563718,0.9300699300699301,0,0.06993006993006994
Zip,98070,Washington,NA,1678,1679,1684,5041,44,68,124,236,18429146,38595269,121118600,178143015,657130,0.026221692491060787,0.04050029779630732,0.07363420427553444,0.04681610791509621,0.1864406779661017,0.288135593220339,0.5254237288135594
Zip,98102,Washington,NA,2287,1159,2196,5642,100,36,102,238,43487614,23352861,228085004,294925479,664153.5,0.043725404459991256,0.031061259706643658,0.04644808743169399,0.04218362282878412,0.42016806722689076,0.15126050420168066,0.42857142857142855
Zip,98110,Washington,NA,2969,2990,3046,9005,71,95,636,802,38729919,75949313,1069814494,1184493726,1339268,0.023913775682047826,0.03177257525083612,0.2087984241628365,0.08906163242642975,0.0885286783042394,0.11845386533665836,0.7930174563591023
Zip,98112,Washington,NA,632,1195,5413,7240,53,60,67,180,23024938,37521001,281159183,341705122,635191,0.08386075949367089,0.0502092050209205,0.012377609458710512,0.024861878453038673,0.29444444444444445,0.3333333333333333,0.37222222222222223
Zip,98116,Washington,NA,1672,3787,3257,8716,72,30,105,207,36227364,21013644,157181273,214422281,784391,0.0430622009569378,0.007921837866385001,0.03223825606386245,0.02374942634235888,0.34782608695652173,0.14492753623188406,0.5072463768115942
Zip,98118,Washington,NA,7856,2979,1515,12350,100,1,64,165,27997820,612968,99916376,128527164,307134,0.012729124236252547,3.356831151393085e-4,0.042244224422442245,0.013360323886639677,0.6060606060606061,0.006060606060606061,0.3878787878787879
Zip,98125,Washington,NA,5121,4307,1685,11113,0,0,158,158,0,0,285636261,285636261,1632694.5,0,0,0.09376854599406528,0.014217583010888149,0,0,1
Zip,98136,Washington,NA,1750,2344,1971,6065,5,3,216,224,2166181,2206607,421603416,425976204,1698596,0.002857142857142857,0.001279863481228669,0.1095890410958904,0.03693322341302556,0.022321428571428572,0.013392857142857142,0.9642857142857143
Zip,98166,Washington,NA,1573,2151,3242,6966,0,0,181,181,0,0,213828573,213828573,1005732,0,0,0.05582973473164713,0.025983347688774045,0,0,1
Zip,98198,Washington,NA,3456,3088,3012,9556,53,8,62,123,12564080,3447069,44325462,60336611,470912,0.015335648148148149,0.0025906735751295338,0.020584329349269587,0.012871494349100041,0.43089430894308944,0.06504065040650407,0.5040650406504065
Zip,98221,Washington,NA,3407,3731,3906,11044,39,36,267,342,11013770,14934053,211674907,237622730,644293,0.011447020839448195,0.009648887697668185,0.06835637480798772,0.03096704092720029,0.11403508771929824,0.10526315789473684,0.7807017543859649
Zip,98226,Washington,NA,6089,5312,5117,16518,199,38,49,286,38281054,13032722,24359474,75673250,209754,0.032681885367055345,0.007153614457831325,0.009575923392612859,0.017314444848044556,0.6958041958041958,0.13286713286713286,0.17132867132867133
Zip,98230,Washington,NA,4052,3754,3755,11561,1436,412,472,2320,166737209,99195705,230273490,496206404,157709,0.3543928923988154,0.10974960042621204,0.12569906790945407,0.2006746821209238,0.6189655172413793,0.17758620689655172,0.20344827586206896
Zip,98232,Washington,NA,466,509,563,1538,141,78,100,319,37646697,31214690,68821048,137682435,355581,0.30257510729613735,0.15324165029469547,0.17761989342806395,0.20741222366710013,0.44200626959247646,0.2445141065830721,0.31347962382445144
Zip,98236,Washington,NA,1183,1091,1254,3528,74,77,406,557,17795818,34434242,360954158,413184218,708025,0.06255283178360102,0.07057745187901009,0.3237639553429027,0.1578798185941043,0.13285457809694792,0.13824057450628366,0.7289048473967684
Zip,98239,Washington,NA,1507,1463,1497,4467,43,45,151,239,10309429,15173602,109855320,135338351,489812,0.028533510285335104,0.030758714969241284,0.1008684034736139,0.053503469890306694,0.1799163179916318,0.18828451882845187,0.6317991631799164
Zip,98248,Washington,NA,3078,3067,3078,9223,231,118,433,782,46528181,32932288,231348153,310808622,400997,0.07504873294346978,0.038474078904466906,0.14067576348278102,0.08478802992518704,0.29539641943734013,0.15089514066496162,0.5537084398976982
Zip,98249,Washington,NA,1168,1174,1163,3505,91,84,369,544,23614124,32582617,500457946,556654687,959265.5,0.0779109589041096,0.07155025553662692,0.3172828890799656,0.15520684736091298,0.16727941176470587,0.15441176470588236,0.6783088235294118
Zip,98250,Washington,NA,1527,1522,1527,4576,53,145,46,244,16109729,74265052,49217218,139591999,507622.5,0.03470857891290111,0.09526938239159001,0.030124426981008513,0.05332167832167832,0.21721311475409835,0.5942622950819673,0.1885245901639344
Zip,98253,Washington,NA,552,544,544,1640,48,65,178,291,11941679,27083841,127788996,166814516,549081,0.08695652173913043,0.11948529411764706,0.3272058823529412,0.1774390243902439,0.16494845360824742,0.22336769759450173,0.6116838487972509
Zip,98257,Washington,NA,633,632,636,1901,120,188,176,484,26258249,57061654,96637224,179957127,319233,0.1895734597156398,0.2974683544303797,0.27672955974842767,0.25460284061020516,0.24793388429752067,0.3884297520661157,0.36363636363636365
Zip,98260,Washington,NA,1039,1161,1140,3340,15,66,147,228,4146935,25588155,114160245,143895335,617948,0.014436958614051972,0.056847545219638244,0.12894736842105264,0.06826347305389222,0.06578947368421052,0.2894736842105263,0.6447368421052632
Zip,98261,Washington,NA,22,118,1737,1877,14,4,108,126,4509360,1322951,70519129,76351440,594504,0.6363636363636364,0.03389830508474576,0.06217616580310881,0.06712839637719765,0.1111111111111111,0.031746031746031744,0.8571428571428571
Zip,98262,Washington,NA,375,375,382,1132,22,31,53,106,4213789,9514782,33295161,47023732,413612.5,0.058666666666666666,0.08266666666666667,0.1387434554973822,0.09363957597173145,0.20754716981132076,0.29245283018867924,0.5
Zip,98271,Washington,NA,4932,2837,3061,10830,44,19,171,234,10828335,5927432,114139674,130895441,452562,0.008921330089213302,0.0066972153683468455,0.0558640967004247,0.021606648199445983,0.18803418803418803,0.0811965811965812,0.7307692307692307
Zip,98273,Washington,NA,3232,3092,2127,8451,46,96,155,297,9692755,27429627,69877680,107000062,335955,0.014232673267326733,0.031047865459249677,0.07287259050305595,0.03514376996805112,0.15488215488215487,0.32323232323232326,0.5218855218855218
Zip,98277,Washington,NA,4337,4342,4313,12992,51,60,232,343,11502088,17592652,141604497,170699237,465999,0.011759280608715702,0.013818516812528788,0.0537908648272664,0.026400862068965518,0.14868804664723032,0.1749271137026239,0.6763848396501457
Zip,98281,Washington,NA,1115,1114,1148,3377,135,199,165,499,19436805,47890512,124074952,191402269,245193,0.1210762331838565,0.17863554757630162,0.1437282229965157,0.1477642878294344,0.27054108216432865,0.39879759519038077,0.3306613226452906
Zip,98282,Washington,NA,3042,3054,3076,9172,132,139,555,826,31335057,54015e3,408970779,494320836,557566.5,0.04339250493096647,0.045514079895219384,0.18042912873862157,0.09005669428696031,0.15980629539951574,0.1682808716707022,0.6719128329297821
Zip,98292,Washington,NA,2625,2643,2726,7994,248,61,190,499,58402985,22398753,124711340,205513078,323346,0.09447619047619048,0.0230798335225123,0.06969919295671313,0.062421816362271704,0.4969939879759519,0.12224448897795591,0.3807615230460922
Zip,98311,Washington,NA,1078,3387,3626,8091,0,2,108,110,0,540159,73410329,73950488,605783.5,0,5.90493061706525e-4,0.02978488692774407,0.013595352861203806,0,0.01818181818181818,0.9818181818181818
Zip,98312,Washington,NA,4198,2370,3462,10030,77,8,334,419,11254598,1892151,189639593,202786342,482946,0.018342067651262506,0.0033755274261603376,0.09647602541883304,0.04177467597208375,0.18377088305489261,0.01909307875894988,0.7971360381861575
Zip,98332,Washington,NA,1650,2323,2748,6721,18,24,136,178,4770359,11184321,135624134,151578814,714463.5,0.01090909090909091,0.010331467929401636,0.049490538573508006,0.02648415414372861,0.10112359550561797,0.1348314606741573,0.7640449438202247
Zip,98333,Washington,NA,521,521,526,1568,8,21,93,122,2940007,13148822,107165963,123254792,933110.5,0.015355086372360844,0.04030710172744722,0.17680608365019013,0.0778061224489796,0.06557377049180328,0.1721311475409836,0.7622950819672131
Zip,98335,Washington,NA,2188,3585,3624,9397,20,21,172,213,6040088,9138375,178466636,193645099,844353,0.009140767824497258,0.005857740585774059,0.04746136865342163,0.022666808555922104,0.09389671361502347,0.09859154929577464,0.8075117370892019
Zip,98340,Washington,NA,456,463,478,1397,15,46,169,230,3896471,22325802,129444689,155666962,643696,0.03289473684210526,0.09935205183585313,0.35355648535564854,0.164638511095204,0.06521739130434782,0.2,0.7347826086956522
Zip,98346,Washington,NA,1253,1189,1229,3671,4,13,101,118,1085466,5116153,90041726,96243345,777865.5,0.0031923383878691143,0.010933557611438183,0.0821806346623271,0.03214383001906838,0.03389830508474576,0.11016949152542373,0.8559322033898306
Zip,98349,Washington,NA,899,883,883,2665,15,25,100,140,2471916,6868563,52517977,61858456,388013.5,0.01668520578420467,0.028312570781426953,0.11325028312570781,0.0525328330206379,0.10714285714285714,0.17857142857142858,0.7142857142857143
Zip,98365,Washington,NA,913,929,933,2775,9,37,55,101,2503578,14077588,29983602,46564768,438832,0.009857612267250822,0.03982777179763186,0.05894962486602358,0.0363963963963964,0.0891089108910891,0.36633663366336633,0.5445544554455446
Zip,98366,Washington,NA,4369,3898,2737,11004,7,27,292,326,1762642,8192764,187209088,197164494,582438.5,0.0016021972991531242,0.006926629040533607,0.10668615272195835,0.029625590694292984,0.02147239263803681,0.08282208588957055,0.8957055214723927
Zip,98370,Washington,NA,3602,3656,3646,10904,7,12,115,134,1832314,4945332,93700922,100478568,727142.5,0.001943364797334814,0.0032822757111597373,0.03154141524958859,0.012289068231841525,0.05223880597014925,0.08955223880597014,0.8582089552238806
Zip,98382,Washington,NA,4288,4292,4333,12913,53,37,184,274,9145463,10248078,103334834,122728375,420503.5,0.012360074626865671,0.008620689655172414,0.04246480498499885,0.021218926663052737,0.19343065693430658,0.13503649635036497,0.6715328467153284
Zip,98402,Washington,NA,418,364,498,1280,0,9,159,168,0,2395038,76415405,78810443,355555,0,0.024725274725274724,0.3192771084337349,0.13125,0,0.05357142857142857,0.9464285714285714
Zip,98424,Washington,NA,826,833,874,2533,115,23,28,166,26820098,7016485,25035089,58871672,254430,0.13922518159806296,0.027611044417767107,0.032036613272311214,0.06553493880773786,0.6927710843373494,0.13855421686746988,0.1686746987951807
Zip,98466,Washington,NA,2898,2330,2525,7753,5,4,100,109,1431920,1408594,84856020,87696534,752140,0.001725327812284334,0.0017167381974248926,0.039603960396039604,0.014059073906874758,0.045871559633027525,0.03669724770642202,0.9174311926605505
Zip,98502,Washington,NA,1765,2879,6363,11007,2,9,231,242,215053,1831307,142077924,144124284,503542,0.0011331444759206798,0.003126085446335533,0.036303630363036306,0.021986008903425093,0.008264462809917356,0.0371900826446281,0.9545454545454546
Zip,98520,Washington,NA,2912,2827,2601,8340,2397,1110,249,3756,189888540,130092060,62846018,382826618,87625,0.8231456043956044,0.39264237707817473,0.09573241061130335,0.4503597122302158,0.6381789137380192,0.2955271565495208,0.06629392971246006
Zip,98528,Washington,NA,1596,1595,1630,4821,32,71,599,702,5277435,19024827,334262184,358564446,452223,0.020050125313283207,0.0445141065830721,0.3674846625766871,0.14561294337274425,0.045584045584045586,0.10113960113960115,0.8532763532763533
Zip,98548,Washington,NA,686,713,730,2129,1,6,94,101,103245,1190291,38912798,40206334,380689,0.0014577259475218659,0.008415147265077139,0.12876712328767123,0.04744011272898074,0.009900990099009901,0.0594059405940594,0.9306930693069307
Zip,98550,Washington,NA,1539,1528,1442,4509,1400,1079,333,2812,106543821,108069942,63949997,278563760,85866,0.9096816114359974,0.706151832460733,0.23092926490984744,0.6236416056775338,0.49786628733997157,0.3837126600284495,0.11842105263157894
Zip,98555,Washington,NA,238,235,251,724,10,33,112,155,1083841,6202514,49529033,56815388,358589,0.04201680672268908,0.14042553191489363,0.44621513944223107,0.21408839779005526,0.06451612903225806,0.2129032258064516,0.7225806451612903
Zip,98569,Washington,NA,3139,3222,3261,9622,148,102,104,354,15649349,14726729,22253668,52629746,138125,0.04714877349474355,0.03165735567970205,0.03189205765102729,0.036790688006651424,0.4180790960451977,0.288135593220339,0.2937853107344633
Zip,98584,Washington,NA,4708,4694,4766,14168,8,41,228,277,1168984,8922679,98174201,108265864,366002,0.0016992353440951572,0.008734554750745633,0.047838858581619806,0.019551101072840204,0.02888086642599278,0.148014440433213,0.8231046931407943
Zip,98588,Washington,NA,469,479,479,1427,17,35,110,162,2340432,7148215,51494123,60982770,351648,0.03624733475479744,0.07306889352818371,0.22964509394572025,0.11352487736510161,0.10493827160493827,0.21604938271604937,0.6790123456790124
Zip,98592,Washington,NA,464,470,493,1427,8,29,135,172,1288202,8020101,73407109,82715412,436490.5,0.017241379310344827,0.06170212765957447,0.2738336713995943,0.12053258584442887,0.046511627906976744,0.1686046511627907,0.7848837209302325
Zip,98595,Washington,NA,558,571,598,1727,119,104,57,280,11670115,14934393,13761194,40365702,131441,0.2132616487455197,0.18213660245183888,0.09531772575250837,0.16213086276780544,0.425,0.37142857142857144,0.20357142857142857
Zip,98612,Washington,NA,365,376,409,1150,91,79,38,208,15299765,20577499,14406737,50284001,230495,0.2493150684931507,0.21010638297872342,0.09290953545232274,0.1808695652173913,0.4375,0.3798076923076923,0.18269230769230768
Zip,32081,Florida,NA,1318,1328,1350,3996,91,42,132,265,26481945,14911480,91112117,132505542,385196,0.06904400606980274,0.03162650602409638,0.09777777777777778,0.06631631631631632,0.3433962264150943,0.15849056603773584,0.4981132075471698
Zip,33578,Florida,NA,5975,4537,3232,13744,8,6,124,138,951799,1311689,56852018,59115506,363355,0.0013389121338912135,0.0013224597751818382,0.038366336633663366,0.010040745052386496,0.057971014492753624,0.043478260869565216,0.8985507246376812
